,reads,uniqs,uniqs_in_bef_OTU,bef_OTU,uniqs_in_aft_OTU,aft_OTU,Got_a_OTU,Got_both,Got_nor,master_OTU
RNBC1_NREP10_tag35_A10,176,159,10,8,6,3,10,6,149,11
RNBC1_NREP10_tag35_A11,919,386,69,25,45,4,69,45,317,29
RNBC1_NREP10_tag35_A12,70,22,11,9,2,2,11,2,11,11
RNBC1_NREP10_tag35_A2,27,14,10,6,5,2,10,5,4,8
RNBC1_NREP10_tag35_A1,6,6,2,2,2,2,2,2,4,4
RNBC1_NREP10_tag35_A3,8926,2176,703,5,702,1,703,702,1473,6
RNBC1_NREP10_tag35_A4,6469,1145,225,16,67,5,225,67,920,21
RNBC1_NREP10_tag35_A5,2116,606,217,21,145,4,217,145,389,25
RNBC1_NREP10_tag35_A6,76,48,27,7,24,4,27,24,21,11
RNBC1_NREP10_tag35_A7,12517,2523,566,9,559,3,566,559,1957,12
RNBC1_NREP10_tag35_A8,1,1,0,0,0,0,0,0,1,0
RNBC1_NREP10_tag35_A9,772,387,166,5,164,2,166,164,221,7
RNBC1_NREP10_tag35_B11,10,8,4,4,4,4,4,4,4,8
RNBC1_NREP10_tag35_B10,3,3,1,1,1,1,1,1,2,2
RNBC1_NREP10_tag35_B12,1750,576,130,3,128,1,130,128,446,4
RNBC1_NREP10_tag35_B1,30,20,8,3,7,2,8,7,12,5
RNBC1_NREP10_tag35_B3,11,7,3,3,0,0,3,0,4,3
RNBC1_NREP10_tag35_B4,6770,1729,603,5,602,1,603,602,1126,6
RNBC1_NREP10_tag35_B5,16,7,4,4,1,1,4,1,3,5
RNBC1_NREP10_tag35_B6,12,11,3,2,3,2,3,3,8,4
RNBC1_NREP10_tag35_B7,70,45,16,4,16,4,16,16,29,8
RNBC1_NREP10_tag35_B8,528,263,43,8,41,4,43,41,220,12
RNBC1_NREP10_tag35_B9,158,68,12,5,12,4,12,12,56,9
RNBC1_NREP10_tag35_C10,19,10,4,3,2,1,4,2,6,4
RNBC1_NREP10_tag35_C11,211,120,25,11,13,2,25,13,95,13
RNBC1_NREP10_tag35_C12,36,21,5,3,3,1,5,3,16,4
RNBC1_NREP10_tag35_C1,21,11,5,5,3,3,5,3,6,8
RNBC1_NREP10_tag35_C5,9,9,2,1,2,1,2,2,7,2
RNBC1_NREP10_tag35_C6,5,4,2,2,1,1,2,1,2,3
RNBC1_NREP10_tag35_C2,1,1,1,1,1,1,1,1,0,2
RNBC1_NREP10_tag35_C4,5,4,3,1,3,1,3,3,1,2
RNBC1_NREP10_tag35_C7,1105,556,85,7,78,2,85,78,471,9
RNBC1_NREP10_tag35_C8,44,22,2,2,2,2,2,2,20,4
RNBC1_NREP10_tag35_C9,387,175,32,7,27,3,32,27,143,10
RNBC1_NREP10_tag35_D10,27,17,6,3,4,1,6,4,11,4
RNBC1_NREP10_tag35_D11,6269,1767,414,7,408,2,414,408,1353,9
RNBC1_NREP10_tag35_D12,241,125,15,10,11,5,15,11,110,15
RNBC1_NREP10_tag35_D1,75,41,9,3,8,2,9,8,32,5
RNBC1_NREP10_tag35_D2,5,4,1,1,1,1,1,1,3,2
RNBC1_NREP10_tag35_D5,127,34,4,2,1,1,4,1,30,3
RNBC1_NREP10_tag35_D4,4,4,2,2,2,2,2,2,2,4
RNBC1_NREP10_tag35_D3,4,4,2,2,2,2,2,2,2,4
RNBC1_NREP10_tag35_D6,26,19,9,1,9,1,9,9,10,2
RNBC1_NREP10_tag35_D7,273,125,14,4,10,2,14,10,111,6
RNBC1_NREP10_tag35_D8,12,12,0,0,0,0,0,0,12,0
RNBC1_NREP10_tag35_D9,2028,778,171,6,168,3,171,168,607,9
RNBC1_NREP10_tag35_E10,361,225,83,23,67,8,83,67,142,31
RNBC1_NREP10_tag35_E11,138,71,12,3,11,2,12,11,59,5
RNBC1_NREP10_tag35_E12,12,9,4,4,2,2,4,2,5,6
RNBC1_NREP10_tag35_E3,10,5,5,5,2,2,5,2,0,7
RNBC1_NREP10_tag35_E2,2,2,0,0,0,0,0,0,2,0
RNBC1_NREP10_tag35_E1,1,1,0,0,0,0,0,0,1,0
RNBC1_NREP10_tag35_E4,36,24,2,2,1,1,2,1,22,3
RNBC1_NREP10_tag35_E5,33,29,4,4,1,1,4,1,25,5
RNBC1_NREP10_tag35_E6,41,8,2,1,0,0,2,0,6,1
RNBC1_NREP10_tag35_E7,106,93,6,5,3,1,6,3,87,6
RNBC1_NREP10_tag35_E8,274,179,13,7,8,2,13,8,166,9
RNBC1_NREP10_tag35_F10,18,9,2,1,0,0,2,0,7,1
RNBC1_NREP10_tag35_E9,9,9,2,2,1,1,2,1,7,3
RNBC1_NREP10_tag35_F11,2856,1085,432,17,419,6,432,419,653,23
RNBC1_NREP10_tag35_F12,30,14,8,8,4,4,8,4,6,12
RNBC1_NREP10_tag35_F3,1579,137,53,7,5,2,53,5,84,9
RNBC1_NREP10_tag35_F2,11,7,3,3,0,0,3,0,4,3
RNBC1_NREP10_tag35_F4,156,73,36,4,35,3,36,35,37,7
RNBC1_NREP10_tag35_F5,210,126,60,8,48,1,60,48,66,9
RNBC1_NREP10_tag35_F6,218,120,64,4,63,3,64,63,56,7
RNBC1_NREP10_tag35_F7,28,19,8,5,5,2,8,5,11,7
RNBC1_NREP10_tag35_F8,90,63,14,6,9,2,14,9,49,8
RNBC1_NREP10_tag35_F9,130,26,12,11,5,5,12,5,14,16
RNBC1_NREP10_tag35_G10,238,180,23,12,10,3,23,10,157,15
RNBC1_NREP10_tag35_G11,8148,3527,511,29,407,10,511,407,3016,39
RNBC1_NREP10_tag35_G12,532,207,100,15,89,4,100,89,107,19
RNBC1_NREP10_tag35_G4,34,9,3,3,1,1,3,1,6,4
RNBC1_NREP10_tag35_G1,7,7,4,2,3,1,4,3,3,3
RNBC1_NREP10_tag35_G2,1,1,1,1,1,1,1,1,0,2
RNBC1_NREP10_tag35_G6,134,57,8,6,3,1,8,3,49,7
RNBC1_NREP10_tag35_G5,4,4,0,0,0,0,0,0,4,0
RNBC1_NREP10_tag35_G7,12,11,3,3,2,2,3,2,8,5
RNBC1_NREP10_tag35_G8,188,105,20,5,17,2,20,17,85,7
RNBC1_NREP10_tag35_G9,3023,1102,239,16,223,4,239,223,863,20
RNBC1_NREP10_tag35_H10,2460,1001,201,5,199,3,201,199,800,8
RNBC1_NREP10_tag35_H11,46,28,7,5,5,3,7,5,21,8
RNBC1_NREP10_tag35_H12,1014,440,221,4,218,1,221,218,219,5
RNBC1_NREP10_tag35_H1,123,58,2,1,2,1,2,2,56,2
RNBC1_NREP10_tag35_H3,67,28,9,8,0,0,9,0,19,8
RNBC1_NREP10_tag35_H2,10,8,2,2,1,1,2,1,6,3
RNBC1_NREP10_tag35_H4,20,13,6,6,5,5,6,5,7,11
RNBC1_NREP10_tag35_H5,99,61,5,1,5,1,5,5,56,2
RNBC1_NREP10_tag35_H6,309,158,33,21,9,6,33,9,125,27
RNBC1_NREP10_tag35_H8,37,33,5,4,2,2,5,2,28,6
RNBC1_NREP10_tag35_H7,1,1,1,1,0,0,1,0,0,1
RNBC1_NREP10_tag35_H9,409,222,80,6,77,3,80,77,142,9
RNBC1_NREP11_tag36_A12,10,9,5,5,5,5,5,5,4,10
RNBC1_NREP11_tag36_A11,2,2,2,2,2,2,2,2,0,4
RNBC1_NREP11_tag36_A1,5,4,2,2,1,1,2,1,2,3
RNBC1_NREP11_tag36_A3,85,60,28,20,26,18,28,26,32,38
RNBC1_NREP11_tag36_A4,73,42,19,12,18,10,19,18,23,22
RNBC1_NREP11_tag36_A5,9,9,7,5,7,5,7,7,2,10
RNBC1_NREP11_tag36_A7,2849,818,300,15,299,13,300,299,518,28
RNBC1_NREP11_tag36_B12,9,8,5,4,5,4,5,5,3,8
RNBC1_NREP11_tag36_B4,14,10,8,5,8,4,8,8,2,9
RNBC1_NREP11_tag36_B7,248,119,29,15,24,12,29,24,90,27
RNBC1_NREP11_tag36_B5,1,1,1,1,1,1,1,1,0,2
RNBC1_NREP11_tag36_B8,64,32,9,4,9,4,9,9,23,8
RNBC1_NREP11_tag36_C11,19,13,5,3,4,2,5,4,8,5
RNBC1_NREP11_tag36_C3,4,3,1,1,0,0,1,0,2,1
RNBC1_NREP11_tag36_C12,10,10,4,2,4,2,4,4,6,4
RNBC1_NREP11_tag36_C7,159,79,7,5,7,5,7,7,72,10
RNBC1_NREP11_tag36_C1,2,2,1,1,1,1,1,1,1,2
RNBC1_NREP11_tag36_C8,7,7,3,2,3,2,3,3,4,4
RNBC1_NREP11_tag36_C9,8,8,5,3,5,3,5,5,3,6
RNBC1_NREP11_tag36_D10,1,1,1,1,1,1,1,1,0,2
RNBC1_NREP11_tag36_D11,34,31,16,11,15,9,16,15,15,20
RNBC1_NREP11_tag36_D12,852,326,55,6,54,6,55,54,271,12
RNBC1_NREP11_tag36_D7,1,1,0,0,0,0,0,0,1,0
RNBC1_NREP11_tag36_D9,26,26,6,5,5,4,6,5,20,9
RNBC1_NREP11_tag36_E10,287,126,41,1,41,1,41,41,85,2
RNBC1_NREP11_tag36_E11,1012,337,59,1,59,1,59,59,278,2
RNBC1_NREP11_tag36_E12,906,319,82,5,82,4,82,82,237,9
RNBC1_NREP11_tag36_E1,1,1,1,1,1,1,1,1,0,2
RNBC1_NREP11_tag36_E3,4,3,2,2,1,1,2,1,1,3
RNBC1_NREP11_tag36_E2,1,1,0,0,0,0,0,0,1,0
RNBC1_NREP11_tag36_E4,1,1,1,1,1,1,1,1,0,2
RNBC1_NREP11_tag36_E5,246,111,16,5,15,4,16,15,95,9
RNBC1_NREP11_tag36_E7,83,38,6,1,6,1,6,6,32,2
RNBC1_NREP11_tag36_E6,1,1,1,1,1,1,1,1,0,2
RNBC1_NREP11_tag36_E8,33,13,3,2,3,2,3,3,10,4
RNBC1_NREP11_tag36_E9,2070,619,146,6,146,2,146,146,473,8
RNBC1_NREP11_tag36_F11,35,26,12,9,12,9,12,12,14,18
RNBC1_NREP11_tag36_F12,626,205,68,3,68,3,68,68,137,6
RNBC1_NREP11_tag36_F1,3,2,1,1,1,1,1,1,1,2
RNBC1_NREP11_tag36_F3,7,4,3,1,3,1,3,3,1,2
RNBC1_NREP11_tag36_F4,113,61,14,2,13,1,14,13,47,3
RNBC1_NREP11_tag36_F5,144,62,20,2,20,2,20,20,42,4
RNBC1_NREP11_tag36_F7,31,21,9,6,9,6,9,9,12,12
RNBC1_NREP11_tag36_F9,5,4,2,2,1,1,2,1,2,3
RNBC1_NREP11_tag36_F8,2,2,2,2,2,2,2,2,0,4
RNBC1_NREP11_tag36_G11,86,50,22,11,20,9,22,20,28,20
RNBC1_NREP11_tag36_G12,111,46,4,2,3,1,4,3,42,3
RNBC1_NREP11_tag36_G6,14,8,4,4,1,1,4,1,4,5
RNBC1_NREP11_tag36_G3,1,1,1,1,1,1,1,1,0,2
RNBC1_NREP11_tag36_G7,12,7,2,2,1,1,2,1,5,3
RNBC1_NREP11_tag36_G8,98,53,10,5,10,5,10,10,43,10
RNBC1_NREP11_tag36_G2,1,1,0,0,0,0,0,0,1,0
RNBC1_NREP11_tag36_G9,52,28,9,8,6,5,9,6,19,13
RNBC1_NREP11_tag36_H10,56,35,10,8,9,7,10,9,25,15
RNBC1_NREP11_tag36_G4,1,1,0,0,0,0,0,0,1,0
RNBC1_NREP11_tag36_H11,36,26,8,6,8,6,8,8,18,12
RNBC1_NREP11_tag36_H12,58,31,5,4,4,3,5,4,26,7
RNBC1_NREP11_tag36_H6,115,66,16,9,15,5,16,15,50,14
RNBC1_NREP11_tag36_H5,1,1,1,1,1,1,1,1,0,2
RNBC1_NREP11_tag36_H4,3,3,3,3,3,3,3,3,0,6
RNBC1_NREP11_tag36_H1,1,1,1,1,1,1,1,1,0,2
RNBC1_NREP11_tag36_H8,129,56,32,1,32,1,32,32,24,2
RNBC1_NREP12_tag37_A10,15,11,5,2,5,2,5,5,6,4
RNBC1_NREP11_tag36_H9,2,2,1,1,1,1,1,1,1,2
RNBC1_NREP12_tag37_A11,458,257,125,29,123,27,125,123,132,56
RNBC1_NREP12_tag37_A12,39,32,8,8,3,3,8,3,24,11
RNBC1_NREP12_tag37_A1,1407,423,62,18,33,7,62,33,361,25
RNBC1_NREP12_tag37_A2,7,3,3,3,1,1,3,1,0,4
RNBC1_NREP12_tag37_A3,5677,2579,495,60,477,48,495,477,2084,108
RNBC1_NREP12_tag37_A4,13134,3303,763,93,710,53,763,710,2540,146
RNBC1_NREP12_tag37_A5,2054,895,190,69,143,40,190,143,705,109
RNBC1_NREP12_tag37_A6,127,47,14,10,7,4,14,7,33,14
RNBC1_NREP12_tag37_A8,15,13,2,2,2,2,2,2,11,4
RNBC1_NREP12_tag37_A9,88,58,17,10,16,9,17,16,41,19
RNBC1_NREP12_tag37_B10,6,6,3,3,2,2,3,2,3,5
RNBC1_NREP12_tag37_B12,28,22,9,8,1,1,9,1,13,9
RNBC1_NREP12_tag37_B11,6,6,0,0,0,0,0,0,6,0
RNBC1_NREP12_tag37_B1,12,12,4,4,4,4,4,4,8,8
RNBC1_NREP12_tag37_B3,115,40,14,5,2,2,14,2,26,7
RNBC1_NREP12_tag37_B2,6,6,1,1,1,1,1,1,5,2
RNBC1_NREP12_tag37_B5,50,29,6,6,4,4,6,4,23,10
RNBC1_NREP12_tag37_B6,10,8,4,4,3,3,4,3,4,7
RNBC1_NREP12_tag37_B8,689,346,56,33,50,26,56,50,290,59
RNBC1_NREP12_tag37_B9,18,16,2,2,2,1,2,2,14,3
RNBC1_NREP12_tag37_C10,52,34,3,3,3,3,3,3,31,6
RNBC1_NREP12_tag37_C12,133,72,15,14,7,6,15,7,57,20
RNBC1_NREP12_tag37_C1,150,106,14,6,11,3,14,11,92,9
RNBC1_NREP12_tag37_C2,8,8,1,1,1,1,1,1,7,2
RNBC1_NREP12_tag37_C3,26,16,4,4,0,0,4,0,12,4
RNBC1_NREP12_tag37_C4,96,58,6,5,4,3,6,4,52,8
RNBC1_NREP12_tag37_C5,5,5,3,3,3,3,3,3,2,6
RNBC1_NREP12_tag37_C6,3,3,1,1,0,0,1,0,2,1
RNBC1_NREP12_tag37_C7,4667,1917,424,109,346,60,424,346,1493,169
RNBC1_NREP12_tag37_C8,474,262,97,28,77,15,97,77,165,43
RNBC1_NREP12_tag37_C9,321,209,66,38,48,19,66,48,143,57
RNBC1_NREP12_tag37_D10,9,8,4,4,2,2,4,2,4,6
RNBC1_NREP12_tag37_D11,154,104,43,24,39,20,43,39,61,44
RNBC1_NREP12_tag37_D1,33,20,7,7,2,2,7,2,13,9
RNBC1_NREP12_tag37_D3,24,22,3,3,0,0,3,0,19,3
RNBC1_NREP12_tag37_D2,1,1,0,0,0,0,0,0,1,0
RNBC1_NREP12_tag37_D4,89,56,16,14,3,3,16,3,40,17
RNBC1_NREP12_tag37_D5,58,38,1,1,1,1,1,1,37,2
RNBC1_NREP12_tag37_D6,20,12,3,3,3,3,3,3,9,6
RNBC1_NREP12_tag37_D7,37,31,7,6,1,1,7,1,24,7
RNBC1_NREP12_tag37_D8,6,6,2,2,2,2,2,2,4,4
RNBC1_NREP12_tag37_D9,952,493,90,34,84,28,90,84,403,62
RNBC1_NREP12_tag37_E10,29,12,4,4,3,3,4,3,8,7
RNBC1_NREP12_tag37_E12,40,33,18,11,13,8,18,13,15,19
RNBC1_NREP12_tag37_E3,3,3,0,0,0,0,0,0,3,0
RNBC1_NREP12_tag37_E1,3,3,3,3,3,3,3,3,0,6
RNBC1_NREP12_tag37_E4,109,62,2,2,2,2,2,2,60,4
RNBC1_NREP12_tag37_E5,177,103,22,17,17,13,22,17,81,30
RNBC1_NREP12_tag37_E6,11,9,3,3,2,2,3,2,6,5
RNBC1_NREP12_tag37_E7,15,14,5,4,5,4,5,5,9,8
RNBC1_NREP12_tag37_E8,166,103,20,7,6,5,20,6,83,12
RNBC1_NREP12_tag37_E9,84,67,18,15,5,4,18,5,49,19
RNBC1_NREP12_tag37_F12,11,11,1,1,0,0,1,0,10,1
RNBC1_NREP12_tag37_F10,2,2,1,1,1,1,1,1,1,2
RNBC1_NREP12_tag37_F2,6,6,0,0,0,0,0,0,6,0
RNBC1_NREP12_tag37_F1,4,4,2,2,2,2,2,2,2,4
RNBC1_NREP12_tag37_F3,30,21,6,5,4,3,6,4,15,8
RNBC1_NREP12_tag37_F4,51,17,6,6,3,3,6,3,11,9
RNBC1_NREP12_tag37_F5,31,18,13,2,13,2,13,13,5,4
RNBC1_NREP12_tag37_F6,22,12,6,5,6,5,6,6,6,10
RNBC1_NREP12_tag37_F7,103,70,17,8,11,5,17,11,53,13
RNBC1_NREP12_tag37_F8,85,56,23,12,18,8,23,18,33,20
RNBC1_NREP12_tag37_F9,50,41,7,5,5,4,7,5,34,9
RNBC1_NREP12_tag37_G10,23,19,5,1,0,0,5,0,14,1
RNBC1_NREP12_tag37_G11,2581,963,180,54,166,40,180,166,783,94
RNBC1_NREP12_tag37_G12,109,51,9,6,7,4,9,7,42,10
RNBC1_NREP12_tag37_G1,12,9,4,3,3,2,4,3,5,5
RNBC1_NREP12_tag37_G2,18,10,1,1,1,1,1,1,9,2
RNBC1_NREP12_tag37_G3,86,54,3,3,1,1,3,1,51,4
RNBC1_NREP12_tag37_G4,28,26,9,7,9,7,9,9,17,14
RNBC1_NREP12_tag37_G6,265,162,28,15,20,11,28,20,134,26
RNBC1_NREP12_tag37_G5,3,3,1,1,1,1,1,1,2,2
RNBC1_NREP12_tag37_G7,117,79,34,12,30,10,34,30,45,22
RNBC1_NREP12_tag37_G8,51,46,16,15,12,10,16,12,30,25
RNBC1_NREP12_tag37_G9,131,67,13,8,6,5,13,6,54,13
RNBC1_NREP12_tag37_H10,3532,861,235,37,230,33,235,230,626,70
RNBC1_NREP12_tag37_H11,462,258,123,42,114,24,123,114,135,66
RNBC1_NREP12_tag37_H12,9,8,1,1,1,1,1,1,7,2
RNBC1_NREP12_tag37_H1,20,13,6,4,5,3,6,5,7,7
RNBC1_NREP12_tag37_H2,29,16,6,3,4,2,6,4,10,5
RNBC1_NREP12_tag37_H3,71,19,6,5,0,0,6,0,13,5
RNBC1_NREP12_tag37_H4,602,307,149,8,146,6,149,146,158,14
RNBC1_NREP12_tag37_H5,2,2,1,1,1,1,1,1,1,2
RNBC1_NREP12_tag37_H6,2160,680,158,23,155,20,158,155,522,43
RNBC1_NREP12_tag37_H8,31,22,9,9,6,6,9,6,13,15
RNBC1_NREP12_tag37_H7,6,6,2,2,1,1,2,1,4,3
RNBC1_NREP12_tag37_H9,75,41,4,3,3,2,4,3,37,5
RNBC1_NREP13_tag51_A10,44,28,3,2,3,2,3,3,25,4
RNBC1_NREP13_tag51_A11,3987,1420,381,5,377,1,381,377,1039,6
RNBC1_NREP13_tag51_A12,57,36,22,8,18,4,22,18,14,12
RNBC1_NREP13_tag51_A1,40,18,6,3,5,2,6,5,12,5
RNBC1_NREP13_tag51_A2,10,6,3,2,1,1,3,1,3,3
RNBC1_NREP13_tag51_A3,57,42,12,11,2,2,12,2,30,13
RNBC1_NREP13_tag51_A4,332,98,14,2,14,2,14,14,84,4
RNBC1_NREP13_tag51_A5,151,87,16,10,12,7,16,12,71,17
RNBC1_NREP13_tag51_A6,169,93,46,9,38,2,46,38,47,11
RNBC1_NREP13_tag51_A7,172,109,19,10,14,6,19,14,90,16
RNBC1_NREP13_tag51_A8,10,9,7,6,6,5,7,6,2,11
RNBC1_NREP13_tag51_A9,336,264,33,6,29,1,33,29,231,7
RNBC1_NREP13_tag51_B10,4,4,1,1,1,1,1,1,3,2
RNBC1_NREP13_tag51_B11,17,8,4,4,1,1,4,1,4,5
RNBC1_NREP13_tag51_B12,2791,990,218,6,214,2,218,214,772,8
RNBC1_NREP13_tag51_B1,77,40,4,2,4,2,4,4,36,4
RNBC1_NREP13_tag51_B3,102,49,15,13,3,3,15,3,34,16
RNBC1_NREP13_tag51_B2,2,2,0,0,0,0,0,0,2,0
RNBC1_NREP13_tag51_B4,40,25,8,4,7,3,8,7,17,7
RNBC1_NREP13_tag51_B5,21,11,5,5,1,1,5,1,6,6
RNBC1_NREP13_tag51_B6,8,6,3,3,2,2,3,2,3,5
RNBC1_NREP13_tag51_B8,83,49,13,10,7,4,13,7,36,14
RNBC1_NREP13_tag51_B9,5,4,1,1,0,0,1,0,3,1
RNBC1_NREP13_tag51_C10,17,9,3,3,0,0,3,0,6,3
RNBC1_NREP13_tag51_C1,9,6,5,4,4,3,5,4,1,7
RNBC1_NREP13_tag51_C4,23,15,6,6,0,0,6,0,9,6
RNBC1_NREP13_tag51_C3,2,2,0,0,0,0,0,0,2,0
RNBC1_NREP13_tag51_C5,8,4,1,1,0,0,1,0,3,1
RNBC1_NREP13_tag51_C6,19,11,2,2,2,2,2,2,9,4
RNBC1_NREP13_tag51_C7,5032,2081,469,22,426,1,469,426,1612,23
RNBC1_NREP13_tag51_C8,1321,563,157,12,152,7,157,152,406,19
RNBC1_NREP13_tag51_C9,158,122,19,17,13,11,19,13,103,28
RNBC1_NREP13_tag51_D10,11,11,6,4,5,3,6,5,5,7
RNBC1_NREP13_tag51_D11,688,437,120,65,65,14,120,65,317,79
RNBC1_NREP13_tag51_D12,3363,1120,300,19,290,9,300,290,820,28
RNBC1_NREP13_tag51_D1,46,33,12,6,8,3,12,8,21,9
RNBC1_NREP13_tag51_D4,20,4,3,3,0,0,3,0,1,3
RNBC1_NREP13_tag51_D3,4,2,2,2,1,1,2,1,0,3
RNBC1_NREP13_tag51_D2,4,4,1,1,1,1,1,1,3,2
RNBC1_NREP13_tag51_D5,10,5,2,2,2,2,2,2,3,4
RNBC1_NREP13_tag51_D6,23,19,7,4,6,4,7,6,12,8
RNBC1_NREP13_tag51_D7,149,59,13,8,4,1,13,4,46,9
RNBC1_NREP13_tag51_D8,873,437,52,5,51,3,52,51,385,8
RNBC1_NREP13_tag51_D9,20745,4724,780,15,767,4,780,767,3944,19
RNBC1_NREP13_tag51_E10,647,191,46,4,21,2,46,21,145,6
RNBC1_NREP13_tag51_E11,2062,1203,114,27,81,7,114,81,1089,34
RNBC1_NREP13_tag51_E12,6125,1672,600,22,576,6,600,576,1072,28
RNBC1_NREP13_tag51_E1,25,10,3,3,1,1,3,1,7,4
RNBC1_NREP13_tag51_E3,17,6,3,3,0,0,3,0,3,3
RNBC1_NREP13_tag51_E4,36,28,5,4,2,1,5,2,23,5
RNBC1_NREP13_tag51_E5,39,27,13,5,11,3,13,11,14,8
RNBC1_NREP13_tag51_E6,52,35,7,7,2,2,7,2,28,9
RNBC1_NREP13_tag51_E7,429,273,20,1,20,1,20,20,253,2
RNBC1_NREP13_tag51_E8,6464,2083,424,6,423,4,424,423,1659,10
RNBC1_NREP13_tag51_E9,162,126,32,25,17,12,32,17,94,37
RNBC1_NREP13_tag51_F10,214,124,13,2,13,2,13,13,111,4
RNBC1_NREP13_tag51_F11,3712,1428,311,11,307,8,311,307,1117,19
RNBC1_NREP13_tag51_F12,112,58,13,11,6,4,13,6,45,15
RNBC1_NREP13_tag51_F1,23,9,4,4,0,0,4,0,5,4
RNBC1_NREP13_tag51_F2,7,6,3,3,0,0,3,0,3,3
RNBC1_NREP13_tag51_F3,40,18,5,5,2,2,5,2,13,7
RNBC1_NREP13_tag51_F4,95,80,14,14,4,4,14,4,66,18
RNBC1_NREP13_tag51_F5,15,15,4,4,3,3,4,3,11,7
RNBC1_NREP13_tag51_F7,10703,2796,538,12,529,4,538,529,2258,16
RNBC1_NREP13_tag51_F8,5701,2076,412,29,379,10,412,379,1664,39
RNBC1_NREP13_tag51_F9,1832,733,131,52,56,4,131,56,602,56
RNBC1_NREP13_tag51_G10,73,46,9,4,8,3,9,8,37,7
RNBC1_NREP13_tag51_G11,559,315,38,9,35,6,38,35,277,15
RNBC1_NREP13_tag51_G12,282,130,26,17,13,5,26,13,104,22
RNBC1_NREP13_tag51_G1,38,34,5,5,1,1,5,1,29,6
RNBC1_NREP13_tag51_G3,10,7,2,2,0,0,2,0,5,2
RNBC1_NREP13_tag51_G2,2,2,0,0,0,0,0,0,2,0
RNBC1_NREP13_tag51_G4,31,16,4,4,2,1,4,2,12,5
RNBC1_NREP13_tag51_G5,6,4,2,2,0,0,2,0,2,2
RNBC1_NREP13_tag51_G6,48,38,10,7,6,3,10,6,28,10
RNBC1_NREP13_tag51_G7,314,191,20,5,20,4,20,20,171,9
RNBC1_NREP13_tag51_G8,624,302,86,7,84,4,86,84,216,11
RNBC1_NREP13_tag51_G9,133,67,15,12,7,4,15,7,52,16
RNBC1_NREP13_tag51_H10,81,67,18,9,16,7,18,16,49,16
RNBC1_NREP13_tag51_H11,67,51,15,9,15,9,15,15,36,18
RNBC1_NREP13_tag51_H12,154,84,19,10,15,6,19,15,65,16
RNBC1_NREP13_tag51_H3,31,23,3,3,1,1,3,1,20,4
RNBC1_NREP13_tag51_H1,6,5,1,1,0,0,1,0,4,1
RNBC1_NREP13_tag51_H2,2,2,1,1,1,1,1,1,1,2
RNBC1_NREP13_tag51_H4,18,13,3,3,1,1,3,1,10,4
RNBC1_NREP13_tag51_H5,7,7,0,0,0,0,0,0,7,0
RNBC1_NREP13_tag51_H6,14009,3930,669,13,661,4,669,661,3261,17
RNBC1_NREP13_tag51_H7,29,17,7,5,4,2,7,4,10,7
RNBC1_NREP13_tag51_H8,320,176,15,3,15,3,15,15,161,6
RNBC1_NREP13_tag51_H9,508,198,36,15,4,2,36,4,162,17
RNBC1_NREP1_tag17_A10,8,6,3,3,3,3,3,3,3,6
RNBC1_NREP1_tag17_A11,88,66,11,4,9,3,11,9,55,7
RNBC1_NREP1_tag17_A12,53,12,2,1,0,0,2,0,10,1
RNBC1_NREP1_tag17_A1,28,16,3,2,0,0,3,0,13,2
RNBC1_NREP1_tag17_A2,4,4,2,2,2,2,2,2,2,4
RNBC1_NREP1_tag17_A3,137,42,7,7,4,4,7,4,35,11
RNBC1_NREP1_tag17_A4,1032,458,46,6,44,4,46,44,412,10
RNBC1_NREP1_tag17_A5,43,12,5,5,1,1,5,1,7,6
RNBC1_NREP1_tag17_A6,9,6,4,4,4,3,4,4,2,7
RNBC1_NREP1_tag17_A7,23330,4004,813,12,809,6,813,809,3191,18
RNBC1_NREP1_tag17_A9,63,27,8,6,2,2,8,2,19,8
RNBC1_NREP1_tag17_A8,2,2,1,1,1,1,1,1,1,2
RNBC1_NREP1_tag17_B10,21,16,8,6,5,3,8,5,8,9
RNBC1_NREP1_tag17_B11,33,25,6,3,6,3,6,6,19,6
RNBC1_NREP1_tag17_B12,46,21,6,5,4,3,6,4,15,8
RNBC1_NREP1_tag17_B1,6,4,1,1,0,0,1,0,3,1
RNBC1_NREP1_tag17_B3,5,5,3,3,3,2,3,3,2,5
RNBC1_NREP1_tag17_B2,7,6,2,1,2,1,2,2,4,2
RNBC1_NREP1_tag17_B4,1502,664,98,10,88,5,98,88,566,15
RNBC1_NREP1_tag17_B5,94,41,9,6,4,2,9,4,32,8
RNBC1_NREP1_tag17_B6,368,102,63,15,61,1,63,61,39,16
RNBC1_NREP1_tag17_B7,13176,4378,760,21,759,7,760,759,3618,28
RNBC1_NREP1_tag17_B8,809,437,63,13,59,9,63,59,374,22
RNBC1_NREP1_tag17_B9,13,11,4,4,2,2,4,2,7,6
RNBC1_NREP1_tag17_C10,567,348,127,9,124,4,127,124,221,13
RNBC1_NREP1_tag17_C11,444,206,33,9,29,5,33,29,173,14
RNBC1_NREP1_tag17_C12,442,190,28,8,24,5,28,24,162,13
RNBC1_NREP1_tag17_C1,102,16,5,2,3,1,5,3,11,3
RNBC1_NREP1_tag17_C2,3,3,3,2,3,2,3,3,0,4
RNBC1_NREP1_tag17_C3,27,13,9,3,8,2,9,8,4,5
RNBC1_NREP1_tag17_C4,5,3,2,2,0,0,2,0,1,2
RNBC1_NREP1_tag17_C6,35,21,3,3,1,1,3,1,18,4
RNBC1_NREP1_tag17_C5,2,2,0,0,0,0,0,0,2,0
RNBC1_NREP1_tag17_C7,2377,539,274,25,273,2,274,273,265,27
RNBC1_NREP1_tag17_C8,51,37,9,9,5,3,9,5,28,12
RNBC1_NREP1_tag17_D10,3,2,1,1,1,1,1,1,1,2
RNBC1_NREP1_tag17_D11,1518,966,117,30,107,11,117,107,849,41
RNBC1_NREP1_tag17_D12,1517,535,118,6,112,2,118,112,417,8
RNBC1_NREP1_tag17_D1,80,24,7,5,1,1,7,1,17,6
RNBC1_NREP1_tag17_D3,17,9,2,2,1,1,2,1,7,3
RNBC1_NREP1_tag17_D4,122,20,6,3,5,2,6,5,14,5
RNBC1_NREP1_tag17_D2,4,4,1,1,1,1,1,1,3,2
RNBC1_NREP1_tag17_D6,35,18,5,5,1,1,5,1,13,6
RNBC1_NREP1_tag17_D5,4,4,1,1,1,1,1,1,3,2
RNBC1_NREP1_tag17_D7,1000,352,56,2,56,2,56,56,296,4
RNBC1_NREP1_tag17_D8,334,160,17,1,17,1,17,17,143,2
RNBC1_NREP1_tag17_D9,6306,1438,388,6,385,3,388,385,1050,9
RNBC1_NREP1_tag17_E10,15,15,4,3,3,2,4,3,11,5
RNBC1_NREP1_tag17_E11,171,59,17,10,11,4,17,11,42,14
RNBC1_NREP1_tag17_E12,228,50,7,4,3,2,7,3,43,6
RNBC1_NREP1_tag17_E1,2,2,1,1,0,0,1,0,1,1
RNBC1_NREP1_tag17_E2,1,1,1,1,1,1,1,1,0,2
RNBC1_NREP1_tag17_E4,35,19,2,1,2,1,2,2,17,2
RNBC1_NREP1_tag17_E3,1,1,1,1,1,1,1,1,0,2
RNBC1_NREP1_tag17_E5,250,140,21,10,11,4,21,11,119,14
RNBC1_NREP1_tag17_E6,4,1,1,1,0,0,1,0,0,1
RNBC1_NREP1_tag17_E7,2,2,1,1,1,1,1,1,1,2
RNBC1_NREP1_tag17_E8,31,24,9,6,9,3,9,9,15,9
RNBC1_NREP1_tag17_F10,51,38,6,6,5,5,6,5,32,11
RNBC1_NREP1_tag17_E9,13,10,4,2,4,2,4,4,6,4
RNBC1_NREP1_tag17_F11,267,150,21,7,21,7,21,21,129,14
RNBC1_NREP1_tag17_F12,28,25,7,6,6,5,7,6,18,11
RNBC1_NREP1_tag17_F1,21,7,3,3,1,1,3,1,4,4
RNBC1_NREP1_tag17_F2,9,7,0,0,0,0,0,0,7,0
RNBC1_NREP1_tag17_F3,54,18,10,8,5,4,10,5,8,12
RNBC1_NREP1_tag17_F5,46,25,8,8,3,3,8,3,17,11
RNBC1_NREP1_tag17_F6,185,80,37,4,34,2,37,34,43,6
RNBC1_NREP1_tag17_F7,2996,1086,212,4,209,3,212,209,874,7
RNBC1_NREP1_tag17_F8,3084,930,228,4,225,2,228,225,702,6
RNBC1_NREP1_tag17_F9,559,200,27,7,25,5,27,25,173,12
RNBC1_NREP1_tag17_G10,56,24,3,2,2,1,3,2,21,3
RNBC1_NREP1_tag17_G11,25273,6161,926,5,926,4,926,926,5235,9
RNBC1_NREP1_tag17_G12,1101,394,74,4,74,4,74,74,320,8
RNBC1_NREP1_tag17_G2,17,13,3,3,3,3,3,3,10,6
RNBC1_NREP1_tag17_G1,8,7,3,3,2,2,3,2,4,5
RNBC1_NREP1_tag17_G3,28,23,2,2,2,2,2,2,21,4
RNBC1_NREP1_tag17_G4,904,418,60,4,59,3,60,59,358,7
RNBC1_NREP1_tag17_G5,52,31,3,3,3,3,3,3,28,6
RNBC1_NREP1_tag17_G6,38,28,7,5,4,3,7,4,21,8
RNBC1_NREP1_tag17_G7,344,205,39,3,38,2,39,38,166,5
RNBC1_NREP1_tag17_G8,806,369,43,3,42,2,43,42,326,5
RNBC1_NREP1_tag17_G9,4678,1547,324,16,316,5,324,316,1223,21
RNBC1_NREP1_tag17_H10,391,150,27,11,8,4,27,8,123,15
RNBC1_NREP1_tag17_H11,74,47,9,5,6,2,9,6,38,7
RNBC1_NREP1_tag17_H12,959,598,63,7,60,3,63,60,535,10
RNBC1_NREP1_tag17_H1,2,2,1,1,1,1,1,1,1,2
RNBC1_NREP1_tag17_H2,3,2,1,1,1,1,1,1,1,2
RNBC1_NREP1_tag17_H3,26,14,3,3,3,3,3,3,11,6
RNBC1_NREP1_tag17_H4,140,101,11,7,8,3,11,8,90,10
RNBC1_NREP1_tag17_H6,1470,724,89,16,74,5,89,74,635,21
RNBC1_NREP1_tag17_H7,98,60,5,1,5,1,5,5,55,2
RNBC1_NREP1_tag17_H8,67,40,4,3,3,2,4,3,36,5
RNBC1_NREP1_tag17_H9,1747,680,117,4,114,1,117,114,563,5
RNBC1_NREP2_tag22_A10,53,17,6,4,3,2,6,3,11,6
RNBC1_NREP2_tag22_A11,3626,1222,251,13,248,4,251,248,971,17
RNBC1_NREP2_tag22_A12,44,31,8,7,4,3,8,4,23,10
RNBC1_NREP2_tag22_A2,2,2,0,0,0,0,0,0,2,0
RNBC1_NREP2_tag22_A4,4162,1381,295,12,289,5,295,289,1086,17
RNBC1_NREP2_tag22_A6,31,18,6,5,5,4,6,5,12,9
RNBC1_NREP2_tag22_A7,4514,1340,328,10,321,5,328,321,1012,15
RNBC1_NREP2_tag22_A9,69,48,9,7,7,4,9,7,39,11
RNBC1_NREP2_tag22_A8,9,9,5,5,5,5,5,5,4,10
RNBC1_NREP2_tag22_B12,169,102,23,7,18,3,23,18,79,10
RNBC1_NREP2_tag22_B10,2,2,2,2,2,2,2,2,0,4
RNBC1_NREP2_tag22_B11,8,5,2,2,2,2,2,2,3,4
RNBC1_NREP2_tag22_B1,9,7,3,2,2,1,3,2,4,3
RNBC1_NREP2_tag22_B2,6,6,4,4,2,2,4,2,2,6
RNBC1_NREP2_tag22_B3,265,132,16,11,5,2,16,5,116,13
RNBC1_NREP2_tag22_B4,12602,6429,802,32,771,5,802,771,5627,37
RNBC1_NREP2_tag22_B5,32,17,9,8,5,4,9,5,8,12
RNBC1_NREP2_tag22_B6,6,5,4,4,4,4,4,4,1,8
RNBC1_NREP2_tag22_B7,6540,1577,378,5,365,2,378,365,1199,7
RNBC1_NREP2_tag22_B8,8314,2409,491,11,483,5,491,483,1918,16
RNBC1_NREP2_tag22_B9,44,30,4,4,2,2,4,2,26,6
RNBC1_NREP2_tag22_C10,62,40,6,5,3,2,6,3,34,7
RNBC1_NREP2_tag22_C11,13116,2298,566,1,566,1,566,566,1732,2
RNBC1_NREP2_tag22_C12,24,19,6,4,3,2,6,3,13,6
RNBC1_NREP2_tag22_C1,6,5,2,2,2,2,2,2,3,4
RNBC1_NREP2_tag22_C3,149,59,15,6,8,3,15,8,44,9
RNBC1_NREP2_tag22_C2,2,2,0,0,0,0,0,0,2,0
RNBC1_NREP2_tag22_C4,18,11,5,3,0,0,5,0,6,3
RNBC1_NREP2_tag22_C5,49,31,7,6,3,3,7,3,24,9
RNBC1_NREP2_tag22_C6,10,8,5,5,3,3,5,3,3,8
RNBC1_NREP2_tag22_C7,3349,1179,253,10,237,3,253,237,926,13
RNBC1_NREP2_tag22_C8,3618,1146,271,10,267,6,271,267,875,16
RNBC1_NREP2_tag22_C9,160,98,14,6,10,3,14,10,84,9
RNBC1_NREP2_tag22_D10,8,8,3,3,3,3,3,3,5,6
RNBC1_NREP2_tag22_D11,10347,2802,597,11,590,6,597,590,2205,17
RNBC1_NREP2_tag22_D12,341,149,34,22,14,5,34,14,115,27
RNBC1_NREP2_tag22_D1,24,13,4,4,2,2,4,2,9,6
RNBC1_NREP2_tag22_D3,13,13,6,4,4,3,6,4,7,7
RNBC1_NREP2_tag22_D2,2,2,0,0,0,0,0,0,2,0
RNBC1_NREP2_tag22_D4,19,13,3,3,1,1,3,1,10,4
RNBC1_NREP2_tag22_D5,64,48,7,4,4,2,7,4,41,6
RNBC1_NREP2_tag22_D6,19,12,2,1,2,1,2,2,10,2
RNBC1_NREP2_tag22_D7,58,50,6,5,4,3,6,4,44,8
RNBC1_NREP2_tag22_D8,333,151,16,7,10,2,16,10,135,9
RNBC1_NREP2_tag22_D9,16605,3534,669,11,643,1,669,643,2865,12
RNBC1_NREP2_tag22_E10,2,2,1,1,1,1,1,1,1,2
RNBC1_NREP2_tag22_E11,673,357,140,27,114,9,140,114,217,36
RNBC1_NREP2_tag22_E12,42,13,4,4,1,1,4,1,9,5
RNBC1_NREP2_tag22_E1,50,20,2,1,2,1,2,2,18,2
RNBC1_NREP2_tag22_E2,5,5,2,2,1,1,2,1,3,3
RNBC1_NREP2_tag22_E3,167,81,6,1,6,1,6,6,75,2
RNBC1_NREP2_tag22_E4,14,13,2,2,0,0,2,0,11,2
RNBC1_NREP2_tag22_E5,9408,2154,490,10,459,3,490,459,1664,13
RNBC1_NREP2_tag22_E6,3179,1031,220,7,197,3,220,197,811,10
RNBC1_NREP2_tag22_E8,20,16,7,7,4,4,7,4,9,11
RNBC1_NREP2_tag22_E9,298,134,18,9,12,4,18,12,116,13
RNBC1_NREP2_tag22_F10,50,29,16,3,15,2,16,15,13,5
RNBC1_NREP2_tag22_F11,1444,525,229,24,208,17,229,208,296,41
RNBC1_NREP2_tag22_F12,419,190,75,14,63,6,75,63,115,20
RNBC1_NREP2_tag22_F1,131,44,14,8,7,2,14,7,30,10
RNBC1_NREP2_tag22_F2,26,15,5,2,2,1,5,2,10,3
RNBC1_NREP2_tag22_F4,93,43,9,6,3,1,9,3,34,7
RNBC1_NREP2_tag22_F5,844,399,46,6,45,5,46,45,353,11
RNBC1_NREP2_tag22_F6,606,352,92,15,81,7,92,81,260,22
RNBC1_NREP2_tag22_F7,1874,1355,178,109,9,3,178,9,1177,112
RNBC1_NREP2_tag22_F8,11393,3577,577,18,562,6,577,562,3000,24
RNBC1_NREP2_tag22_F9,631,81,20,5,5,2,20,5,61,7
RNBC1_NREP2_tag22_G10,182,82,19,15,1,1,19,1,63,16
RNBC1_NREP2_tag22_G11,10721,3176,657,49,619,14,657,619,2519,63
RNBC1_NREP2_tag22_G12,247,121,26,16,13,7,26,13,95,23
RNBC1_NREP2_tag22_G1,59,10,9,7,3,2,9,3,1,9
RNBC1_NREP2_tag22_G2,10,5,3,2,1,1,3,1,2,3
RNBC1_NREP2_tag22_G4,2,2,0,0,0,0,0,0,2,0
RNBC1_NREP2_tag22_G3,3,3,3,2,2,1,3,2,0,3
RNBC1_NREP2_tag22_G5,745,287,66,3,65,2,66,65,221,5
RNBC1_NREP2_tag22_G6,242,155,37,19,9,4,37,9,118,23
RNBC1_NREP2_tag22_G7,804,528,86,36,19,8,86,19,442,44
RNBC1_NREP2_tag22_G9,384,195,29,17,12,9,29,12,166,26
RNBC1_NREP2_tag22_G8,4,3,1,1,1,1,1,1,2,2
RNBC1_NREP2_tag22_H10,3902,1521,278,9,274,4,278,274,1243,13
RNBC1_NREP2_tag22_H11,271,131,60,10,59,9,60,59,71,19
RNBC1_NREP2_tag22_H12,6865,1721,422,9,418,5,422,418,1299,14
RNBC1_NREP2_tag22_H2,28,27,6,3,2,2,6,2,21,5
RNBC1_NREP2_tag22_H1,1,1,1,1,1,1,1,1,0,2
RNBC1_NREP2_tag22_H5,576,251,36,7,33,4,36,33,215,11
RNBC1_NREP2_tag22_H3,1,1,0,0,0,0,0,0,1,0
RNBC1_NREP2_tag22_H7,258,130,20,15,12,7,20,12,110,22
RNBC1_NREP2_tag22_H8,1434,521,102,5,99,2,102,99,419,7
RNBC1_NREP2_tag22_H9,3,2,1,1,0,0,1,0,1,1
RNBC1_NREP3_tag31_A10,788,172,97,9,6,2,97,6,75,11
RNBC1_NREP3_tag31_A11,177,63,8,3,8,3,8,8,55,6
RNBC1_NREP3_tag31_A12,93,25,11,10,1,1,11,1,14,11
RNBC1_NREP3_tag31_A1,11,7,3,3,2,2,3,2,4,5
RNBC1_NREP3_tag31_A3,1803,587,83,22,28,4,83,28,504,26
RNBC1_NREP3_tag31_A2,2,2,0,0,0,0,0,0,2,0
RNBC1_NREP3_tag31_A4,544,222,45,25,19,10,45,19,177,35
RNBC1_NREP3_tag31_A5,6,4,2,2,1,1,2,1,2,3
RNBC1_NREP3_tag31_A6,24,20,5,4,5,4,5,5,15,8
RNBC1_NREP3_tag31_A7,57,33,5,1,0,0,5,0,28,1
RNBC1_NREP3_tag31_A8,11,11,0,0,0,0,0,0,11,0
RNBC1_NREP3_tag31_A9,435,122,17,4,16,3,17,16,105,7
RNBC1_NREP3_tag31_B11,190,63,33,7,3,2,33,3,30,9
RNBC1_NREP3_tag31_B10,4,4,3,2,3,2,3,3,1,4
RNBC1_NREP3_tag31_B12,397,184,20,5,17,2,20,17,164,7
RNBC1_NREP3_tag31_B1,9,7,3,3,0,0,3,0,4,3
RNBC1_NREP3_tag31_B2,3,3,0,0,0,0,0,0,3,0
RNBC1_NREP3_tag31_B4,5616,1063,497,6,495,4,497,495,566,10
RNBC1_NREP3_tag31_B5,32,20,9,7,6,3,9,6,11,10
RNBC1_NREP3_tag31_B6,3,3,1,1,0,0,1,0,2,1
RNBC1_NREP3_tag31_B7,40,23,8,8,6,6,8,6,15,14
RNBC1_NREP3_tag31_B8,198,77,22,13,14,7,22,14,55,20
RNBC1_NREP3_tag31_B9,4,3,2,2,1,1,2,1,1,3
RNBC1_NREP3_tag31_C10,30,15,7,7,6,6,7,6,8,13
RNBC1_NREP3_tag31_C11,2319,608,346,3,346,3,346,346,262,6
RNBC1_NREP3_tag31_C12,280,127,21,10,17,6,21,17,106,16
RNBC1_NREP3_tag31_C1,85,10,2,1,0,0,2,0,8,1
RNBC1_NREP3_tag31_C4,10,9,2,2,1,1,2,1,7,3
RNBC1_NREP3_tag31_C3,3,3,2,2,2,2,2,2,1,4
RNBC1_NREP3_tag31_C6,34,5,3,3,2,2,3,2,2,5
RNBC1_NREP3_tag31_C2,1,1,0,0,0,0,0,0,1,0
RNBC1_NREP3_tag31_C7,1171,372,71,33,44,11,71,44,301,44
RNBC1_NREP3_tag31_C8,760,320,47,15,36,3,47,36,273,18
RNBC1_NREP3_tag31_C9,126,72,18,17,11,10,18,11,54,27
RNBC1_NREP3_tag31_D10,4,4,3,3,1,1,3,1,1,4
RNBC1_NREP3_tag31_D11,81,66,9,5,6,2,9,6,57,7
RNBC1_NREP3_tag31_D12,262,60,18,16,6,5,18,6,42,21
RNBC1_NREP3_tag31_D3,8,3,1,1,0,0,1,0,2,1
RNBC1_NREP3_tag31_D1,5,5,2,2,2,2,2,2,3,4
RNBC1_NREP3_tag31_D4,60,27,9,7,9,6,9,9,18,13
RNBC1_NREP3_tag31_D2,5,4,2,2,2,2,2,2,2,4
RNBC1_NREP3_tag31_D7,77,68,9,9,4,3,9,4,59,12
RNBC1_NREP3_tag31_D6,16,10,1,1,1,1,1,1,9,2
RNBC1_NREP3_tag31_D5,1,1,0,0,0,0,0,0,1,0
RNBC1_NREP3_tag31_D8,12,6,2,1,2,1,2,2,4,2
RNBC1_NREP3_tag31_D9,14111,2463,1025,7,1024,5,1025,1024,1438,12
RNBC1_NREP3_tag31_E10,8,6,2,2,2,2,2,2,4,4
RNBC1_NREP3_tag31_E11,347,153,72,5,72,6,72,72,81,11
RNBC1_NREP3_tag31_E12,174,86,11,8,11,8,11,11,75,16
RNBC1_NREP3_tag31_E1,60,32,2,1,2,1,2,2,30,2
RNBC1_NREP3_tag31_E3,37,22,8,6,5,4,8,5,14,10
RNBC1_NREP3_tag31_E2,1,1,0,0,0,0,0,0,1,0
RNBC1_NREP3_tag31_E4,59,31,5,4,3,2,5,3,26,6
RNBC1_NREP3_tag31_E5,954,440,64,7,62,4,64,62,376,11
RNBC1_NREP3_tag31_E6,248,119,13,4,12,3,13,12,106,7
RNBC1_NREP3_tag31_E7,12,4,1,1,0,0,1,0,3,1
RNBC1_NREP3_tag31_E8,92,44,9,7,7,4,9,7,35,11
RNBC1_NREP3_tag31_E9,291,136,51,19,35,10,51,35,85,29
RNBC1_NREP3_tag31_F10,6,6,3,3,1,1,3,1,3,4
RNBC1_NREP3_tag31_F11,11401,1801,484,5,482,3,484,482,1317,8
RNBC1_NREP3_tag31_F12,1339,508,72,18,21,2,72,21,436,20
RNBC1_NREP3_tag31_F1,23,9,4,4,2,2,4,2,5,6
RNBC1_NREP3_tag31_F3,70,42,6,6,3,3,6,3,36,9
RNBC1_NREP3_tag31_F2,1,1,0,0,0,0,0,0,1,0
RNBC1_NREP3_tag31_F4,300,54,11,8,3,3,11,3,43,11
RNBC1_NREP3_tag31_F5,16,14,1,1,0,0,1,0,13,1
RNBC1_NREP3_tag31_F6,8,6,3,3,2,2,3,2,3,5
RNBC1_NREP3_tag31_F8,1147,394,232,11,226,5,232,226,162,16
RNBC1_NREP3_tag31_F9,55,18,6,4,6,4,6,6,12,8
RNBC1_NREP3_tag31_G10,266,103,12,3,10,1,12,10,91,4
RNBC1_NREP3_tag31_G12,11,9,2,2,1,1,2,1,7,3
RNBC1_NREP3_tag31_G1,13,8,4,4,2,2,4,2,4,6
RNBC1_NREP3_tag31_G3,21,11,1,1,0,0,1,0,10,1
RNBC1_NREP3_tag31_G2,3,3,0,0,0,0,0,0,3,0
RNBC1_NREP3_tag31_G4,2083,603,144,6,139,2,144,139,459,8
RNBC1_NREP3_tag31_G6,4298,1243,265,9,260,2,265,260,978,11
RNBC1_NREP3_tag31_G5,2,2,1,1,1,1,1,1,1,2
RNBC1_NREP3_tag31_G7,14,13,1,1,0,0,1,0,12,1
RNBC1_NREP3_tag31_G8,22,15,2,1,2,1,2,2,13,2
RNBC1_NREP3_tag31_G9,19,15,4,3,2,1,4,2,11,4
RNBC1_NREP3_tag31_H10,10866,2005,525,2,525,2,525,525,1480,4
RNBC1_NREP3_tag31_H11,5780,2122,406,17,396,3,406,396,1716,20
RNBC1_NREP3_tag31_H12,26,12,4,4,4,4,4,4,8,8
RNBC1_NREP3_tag31_H1,12,11,4,2,4,2,4,4,7,4
RNBC1_NREP3_tag31_H2,563,226,25,2,1,1,25,1,201,3
RNBC1_NREP3_tag31_H4,21,14,4,2,4,2,4,4,10,4
RNBC1_NREP3_tag31_H5,32,19,4,3,3,2,4,3,15,5
RNBC1_NREP3_tag31_H6,411,216,34,8,22,1,34,22,182,9
RNBC1_NREP3_tag31_H8,12,10,2,2,0,0,2,0,8,2
RNBC1_NREP3_tag31_H7,8,8,2,1,2,1,2,2,6,2
RNBC1_NREP3_tag31_H9,19,16,1,1,1,1,1,1,15,2
RNBC1_NREP8_tag32_A11,95,55,8,7,4,3,8,4,47,10
RNBC1_NREP8_tag32_A10,3,3,1,1,1,1,1,1,2,2
RNBC1_NREP8_tag32_A12,190,104,51,2,51,2,51,51,53,4
RNBC1_NREP8_tag32_A1,149,59,4,1,4,1,4,4,55,2
RNBC1_NREP8_tag32_A2,5,5,1,1,1,1,1,1,4,2
RNBC1_NREP8_tag32_A3,1008,397,69,12,64,8,69,64,328,20
RNBC1_NREP8_tag32_A4,157,93,20,11,10,3,20,10,73,14
RNBC1_NREP8_tag32_A5,7,6,4,4,2,2,4,2,2,6
RNBC1_NREP8_tag32_A7,2580,740,203,8,198,4,203,198,537,12
RNBC1_NREP8_tag32_A6,3,3,1,1,1,1,1,1,2,2
RNBC1_NREP8_tag32_A8,5,4,1,1,1,1,1,1,3,2
RNBC1_NREP8_tag32_B10,2,2,0,0,0,0,0,0,2,0
RNBC1_NREP8_tag32_A9,3,3,2,2,2,2,2,2,1,4
RNBC1_NREP8_tag32_B11,241,89,12,1,12,1,12,12,77,2
RNBC1_NREP8_tag32_B12,533,222,37,5,35,3,37,35,185,8
RNBC1_NREP8_tag32_B2,4,4,2,2,2,2,2,2,2,4
RNBC1_NREP8_tag32_B3,110,49,31,2,31,2,31,31,18,4
RNBC1_NREP8_tag32_B4,1352,445,192,2,192,2,192,192,253,4
RNBC1_NREP8_tag32_B5,10,7,3,3,0,0,3,0,4,3
RNBC1_NREP8_tag32_B6,1,1,1,1,1,1,1,1,0,2
RNBC1_NREP8_tag32_B7,8836,3609,806,22,753,5,806,753,2803,27
RNBC1_NREP8_tag32_B8,6,4,4,4,4,4,4,4,0,8
RNBC1_NREP8_tag32_C10,64,27,10,2,9,1,10,9,17,3
RNBC1_NREP8_tag32_B9,1,1,0,0,0,0,0,0,1,0
RNBC1_NREP8_tag32_C11,137,80,31,20,20,8,31,20,49,28
RNBC1_NREP8_tag32_C12,573,248,108,7,103,2,108,103,140,9
RNBC1_NREP8_tag32_C1,33,10,4,2,0,0,4,0,6,2
RNBC1_NREP8_tag32_C4,1,1,1,1,1,1,1,1,0,2
RNBC1_NREP8_tag32_C5,11,6,4,2,4,2,4,4,2,4
RNBC1_NREP8_tag32_C3,1,1,1,1,0,0,1,0,0,1
RNBC1_NREP8_tag32_C2,1,1,0,0,0,0,0,0,1,0
RNBC1_NREP8_tag32_C6,66,59,27,10,22,4,27,22,32,14
RNBC1_NREP8_tag32_C7,1857,626,132,9,126,3,132,126,494,12
RNBC1_NREP8_tag32_C9,886,281,126,9,120,3,126,120,155,12
RNBC1_NREP8_tag32_D11,216,108,35,17,25,8,35,25,73,25
RNBC1_NREP8_tag32_D10,3,3,1,1,1,1,1,1,2,2
RNBC1_NREP8_tag32_D12,19,14,7,5,6,4,7,6,7,9
RNBC1_NREP8_tag32_D4,11,7,3,3,0,0,3,0,4,3
RNBC1_NREP8_tag32_D1,2,2,1,1,0,0,1,0,1,1
RNBC1_NREP8_tag32_D5,12,11,10,2,9,1,10,9,1,3
RNBC1_NREP8_tag32_D7,54,27,18,4,15,1,18,15,9,5
RNBC1_NREP8_tag32_D6,3,2,2,2,0,0,2,0,0,2
RNBC1_NREP8_tag32_D8,14,9,1,1,0,0,1,0,8,1
RNBC1_NREP8_tag32_D9,1096,381,132,4,131,3,132,131,249,7
RNBC1_NREP8_tag32_E10,23,14,5,5,4,4,5,4,9,9
RNBC1_NREP8_tag32_E12,81,18,10,9,5,5,10,5,8,14
RNBC1_NREP8_tag32_E11,1,1,0,0,0,0,0,0,1,0
RNBC1_NREP8_tag32_E1,4,4,1,1,0,0,1,0,3,1
RNBC1_NREP8_tag32_E3,9,3,2,2,0,0,2,0,1,2
RNBC1_NREP8_tag32_E4,3,2,1,1,0,0,1,0,1,1
RNBC1_NREP8_tag32_E2,1,1,0,0,0,0,0,0,1,0
RNBC1_NREP8_tag32_E5,132,76,24,9,22,7,24,22,52,16
RNBC1_NREP8_tag32_E6,20,10,5,4,2,1,5,2,5,5
RNBC1_NREP8_tag32_E7,36,20,8,7,2,1,8,2,12,8
RNBC1_NREP8_tag32_E8,19,13,6,5,4,3,6,4,7,8
RNBC1_NREP8_tag32_E9,15,11,3,3,2,2,3,2,8,5
RNBC1_NREP8_tag32_F10,11,9,4,4,2,2,4,2,5,6
RNBC1_NREP8_tag32_F11,1361,533,217,26,193,8,217,193,316,34
RNBC1_NREP8_tag32_F1,3,2,1,1,0,0,1,0,1,1
RNBC1_NREP8_tag32_F3,7,4,2,2,1,1,2,1,2,3
RNBC1_NREP8_tag32_F2,2,1,1,1,0,0,1,0,0,1
RNBC1_NREP8_tag32_F12,6,6,3,3,3,3,3,3,3,6
RNBC1_NREP8_tag32_F5,6,5,2,2,2,2,2,2,3,4
RNBC1_NREP8_tag32_F6,3,3,2,2,2,2,2,2,1,4
RNBC1_NREP8_tag32_F7,3016,1085,256,18,225,4,256,225,829,22
RNBC1_NREP8_tag32_F8,676,288,121,11,116,6,121,116,167,17
RNBC1_NREP8_tag32_F9,215,63,24,18,5,3,24,5,39,21
RNBC1_NREP8_tag32_G10,50,25,16,3,15,2,16,15,9,5
RNBC1_NREP8_tag32_G11,38,24,5,5,3,3,5,3,19,8
RNBC1_NREP8_tag32_G12,1102,427,70,10,65,5,70,65,357,15
RNBC1_NREP8_tag32_G3,5,3,2,2,1,1,2,1,1,3
RNBC1_NREP8_tag32_G1,1,1,1,1,1,1,1,1,0,2
RNBC1_NREP8_tag32_G4,15,12,4,3,3,2,4,3,8,5
RNBC1_NREP8_tag32_G6,40,25,5,5,2,2,5,2,20,7
RNBC1_NREP8_tag32_G7,17,12,3,3,3,3,3,3,9,6
RNBC1_NREP8_tag32_G8,59,27,5,4,2,2,5,2,22,6
RNBC1_NREP8_tag32_G9,4654,1060,307,5,305,3,307,305,753,8
RNBC1_NREP8_tag32_H10,29,23,3,2,2,1,3,2,20,3
RNBC1_NREP8_tag32_H11,23,15,4,4,2,2,4,2,11,6
RNBC1_NREP8_tag32_H12,53,19,10,5,5,2,10,5,9,7
RNBC1_NREP8_tag32_H1,3,3,1,1,0,0,1,0,2,1
RNBC1_NREP8_tag32_H4,29,17,8,5,6,3,8,6,9,8
RNBC1_NREP8_tag32_H3,2,2,0,0,0,0,0,0,2,0
RNBC1_NREP8_tag32_H2,2,1,1,1,1,1,1,1,0,2
RNBC1_NREP8_tag32_H6,3276,897,209,30,184,13,209,184,688,43
RNBC1_NREP8_tag32_H5,1,1,0,0,0,0,0,0,1,0
RNBC1_NREP8_tag32_H7,1,1,0,0,0,0,0,0,1,0
RNBC1_NREP8_tag32_H8,84,42,19,5,18,2,19,18,23,7
RNBC1_NREP8_tag32_H9,85,45,23,8,15,1,23,15,22,9
RNBC1_NREP9_tag33_A10,106,78,11,7,3,2,11,3,67,9
RNBC1_NREP9_tag33_A11,41,30,11,7,7,4,11,7,19,11
RNBC1_NREP9_tag33_A12,63,30,13,12,7,3,13,7,17,15
RNBC1_NREP9_tag33_A1,29,21,6,5,5,4,6,5,15,9
RNBC1_NREP9_tag33_A2,8,7,2,2,1,1,2,1,5,3
RNBC1_NREP9_tag33_A3,3193,1017,236,12,226,2,236,226,781,14
RNBC1_NREP9_tag33_A4,12,5,2,2,2,2,2,2,3,4
RNBC1_NREP9_tag33_A5,392,236,47,24,27,5,47,27,189,29
RNBC1_NREP9_tag33_A7,5565,1396,346,29,328,7,346,328,1050,36
RNBC1_NREP9_tag33_A6,2,2,0,0,0,0,0,0,2,0
RNBC1_NREP9_tag33_A9,12,11,2,2,0,0,2,0,9,2
RNBC1_NREP9_tag33_B12,36,24,13,1,13,1,13,13,11,2
RNBC1_NREP9_tag33_B10,1,1,1,1,1,1,1,1,0,2
RNBC1_NREP9_tag33_B11,1,1,1,1,1,1,1,1,0,2
RNBC1_NREP9_tag33_B3,4,3,1,1,0,0,1,0,2,1
RNBC1_NREP9_tag33_B1,4,1,1,1,1,1,1,1,0,2
RNBC1_NREP9_tag33_B5,3,3,1,1,1,1,1,1,2,2
RNBC1_NREP9_tag33_B6,2,2,1,1,1,1,1,1,1,2
RNBC1_NREP9_tag33_B7,110,65,6,2,6,2,6,6,59,4
RNBC1_NREP9_tag33_B8,695,345,63,16,54,4,63,54,282,20
RNBC1_NREP9_tag33_B9,5,4,2,1,2,1,2,2,2,2
RNBC1_NREP9_tag33_C10,4,4,2,2,2,2,2,2,2,4
RNBC1_NREP9_tag33_C11,2472,1025,191,16,183,3,191,183,834,19
RNBC1_NREP9_tag33_C12,18,11,3,1,3,1,3,3,8,2
RNBC1_NREP9_tag33_C4,4,2,2,2,1,1,2,1,0,3
RNBC1_NREP9_tag33_C3,8,4,1,1,1,1,1,1,3,2
RNBC1_NREP9_tag33_C1,1,1,0,0,0,0,0,0,1,0
RNBC1_NREP9_tag33_C5,8,5,2,1,2,1,2,2,3,2
RNBC1_NREP9_tag33_C6,16,10,8,1,8,1,8,8,2,2
RNBC1_NREP9_tag33_C7,313,129,39,5,33,4,39,33,90,9
RNBC1_NREP9_tag33_C9,1800,541,121,3,121,3,121,121,420,6
RNBC1_NREP9_tag33_C8,2,2,0,0,0,0,0,0,2,0
RNBC1_NREP9_tag33_D10,18,8,3,3,3,3,3,3,5,6
RNBC1_NREP9_tag33_D12,195,87,7,2,7,2,7,7,80,4
RNBC1_NREP9_tag33_D5,3,3,3,2,2,1,3,2,0,3
RNBC1_NREP9_tag33_D1,1,1,1,1,1,1,1,1,0,2
RNBC1_NREP9_tag33_D2,1,1,0,0,0,0,0,0,1,0
RNBC1_NREP9_tag33_D7,7,7,2,2,2,2,2,2,5,4
RNBC1_NREP9_tag33_D8,11,6,1,1,1,1,1,1,5,2
RNBC1_NREP9_tag33_D9,30,27,2,2,0,0,2,0,25,2
RNBC1_NREP9_tag33_E10,386,161,22,3,22,3,22,22,139,6
RNBC1_NREP9_tag33_E11,140,71,45,4,42,1,45,42,26,5
RNBC1_NREP9_tag33_E12,323,130,17,4,16,3,17,16,113,7
RNBC1_NREP9_tag33_E1,4,1,1,1,0,0,1,0,0,1
RNBC1_NREP9_tag33_E6,3,3,3,2,2,1,3,2,0,3
RNBC1_NREP9_tag33_E2,1,1,1,1,1,1,1,1,0,2
RNBC1_NREP9_tag33_E3,1,1,0,0,0,0,0,0,1,0
RNBC1_NREP9_tag33_E7,27,17,7,3,6,2,7,6,10,5
RNBC1_NREP9_tag33_E4,1,1,0,0,0,0,0,0,1,0
RNBC1_NREP9_tag33_E8,56,31,9,2,9,2,9,9,22,4
RNBC1_NREP9_tag33_E9,1610,497,110,2,110,2,110,110,387,4
RNBC1_NREP9_tag33_F12,28,8,4,4,1,1,4,1,4,5
RNBC1_NREP9_tag33_F10,4,4,2,2,1,1,2,1,2,3
RNBC1_NREP9_tag33_F1,10,7,2,2,1,1,2,1,5,3
RNBC1_NREP9_tag33_F3,88,46,14,1,14,1,14,14,32,2
RNBC1_NREP9_tag33_F2,1,1,1,1,1,1,1,1,0,2
RNBC1_NREP9_tag33_F5,14,11,4,3,3,2,4,3,7,5
RNBC1_NREP9_tag33_F4,2,2,0,0,0,0,0,0,2,0
RNBC1_NREP9_tag33_F6,1,1,0,0,0,0,0,0,1,0
RNBC1_NREP9_tag33_F7,1574,593,106,16,94,4,106,94,487,20
RNBC1_NREP9_tag33_F8,219,89,7,1,7,1,7,7,82,2
RNBC1_NREP9_tag33_F9,129,67,11,4,11,4,11,11,56,8
RNBC1_NREP9_tag33_G10,2,2,0,0,0,0,0,0,2,0
RNBC1_NREP9_tag33_G11,25,19,5,4,2,2,5,2,14,6
RNBC1_NREP9_tag33_G12,356,126,15,4,5,2,15,5,111,6
RNBC1_NREP9_tag33_G1,11,4,1,1,1,1,1,1,3,2
RNBC1_NREP9_tag33_G4,1,1,0,0,0,0,0,0,1,0
RNBC1_NREP9_tag33_G3,2,2,1,1,1,1,1,1,1,2
RNBC1_NREP9_tag33_G5,27,15,3,1,3,1,3,3,12,2
RNBC1_NREP9_tag33_G6,1061,405,74,3,73,2,74,73,331,5
RNBC1_NREP9_tag33_G2,1,1,0,0,0,0,0,0,1,0
RNBC1_NREP9_tag33_G8,683,218,49,4,48,2,49,48,169,6
RNBC1_NREP9_tag33_G9,1740,601,117,19,100,9,117,100,484,28
RNBC1_NREP9_tag33_H10,7182,1516,406,2,406,2,406,406,1110,4
RNBC1_NREP9_tag33_H11,13708,2370,560,6,559,5,560,559,1810,11
RNBC1_NREP9_tag33_H12,88,48,13,6,9,2,13,9,35,8
RNBC1_NREP9_tag33_H2,6,6,4,3,4,3,4,4,2,6
RNBC1_NREP9_tag33_H3,35,18,9,4,8,3,9,8,9,7
RNBC1_NREP9_tag33_H4,188,44,3,1,3,1,3,3,41,2
RNBC1_NREP9_tag33_H5,17,10,8,3,8,2,8,8,2,5
RNBC1_NREP9_tag33_H6,1567,634,220,14,194,7,220,194,414,21
RNBC1_NREP9_tag33_H7,5,5,2,2,2,2,2,2,3,4
RNBC1_NREP9_tag33_H8,557,247,32,6,32,3,32,32,215,9
RNMB_Foping_BS_P1_tag21_A10,672,458,104,41,95,28,104,95,354,69
RNBC1_NREP9_tag33_H9,1,1,1,1,1,1,1,1,0,2
RNMB_Foping_BS_P1_tag21_A11,13059,5713,1523,152,1429,55,1523,1429,4190,207
RNMB_Foping_BS_P1_tag21_A12,7291,4139,1101,141,1031,55,1101,1031,3038,196
RNMB_Foping_BS_P1_tag21_A1,2490,1030,594,40,571,18,594,571,436,58
RNMB_Foping_BS_P1_tag21_A2,1173,563,344,24,336,15,344,336,219,39
RNMB_Foping_BS_P1_tag21_A3,54109,16408,4545,182,4325,60,4545,4325,11863,242
RNMB_Foping_BS_P1_tag21_A4,40625,10785,3014,133,2790,33,3014,2790,7771,166
RNMB_Foping_BS_P1_tag21_A5,33976,10515,3075,158,2826,29,3075,2826,7440,187
RNMB_Foping_BS_P1_tag21_A6,1389,656,367,51,337,23,367,337,289,74
RNMB_Foping_BS_P1_tag21_A7,25895,12229,2650,291,2425,73,2650,2425,9579,364
RNMB_Foping_BS_P1_tag21_A8,43,42,21,18,20,16,21,20,21,34
RNMB_Foping_BS_P1_tag21_A9,1138,712,128,27,118,19,128,118,584,46
RNMB_Foping_BS_P1_tag21_B10,72,57,31,21,29,17,31,29,26,38
RNMB_Foping_BS_P1_tag21_B11,73,57,23,17,19,13,23,19,34,30
RNMB_Foping_BS_P1_tag21_B12,1746,1011,378,68,344,31,378,344,633,99
RNMB_Foping_BS_P1_tag21_B1,9376,2821,1263,54,1215,17,1263,1215,1558,71
RNMB_Foping_BS_P1_tag21_B2,255,159,97,9,96,8,97,96,62,17
RNMB_Foping_BS_P1_tag21_B3,4240,1837,887,68,855,27,887,855,950,95
RNMB_Foping_BS_P1_tag21_B4,26654,7084,2405,108,2258,24,2405,2258,4679,132
RNMB_Foping_BS_P1_tag21_B5,2967,1190,635,39,618,20,635,618,555,59
RNMB_Foping_BS_P1_tag21_B6,57,44,23,15,20,12,23,20,21,27
RNMB_Foping_BS_P1_tag21_B7,22648,9412,2482,230,2347,72,2482,2347,6930,302
RNMB_Foping_BS_P1_tag21_B8,8099,3295,1162,146,1066,58,1162,1066,2133,204
RNMB_Foping_BS_P1_tag21_B9,173,119,32,16,28,11,32,28,87,27
RNMB_Foping_BS_P1_tag21_C10,705,454,143,41,133,27,143,133,311,68
RNMB_Foping_BS_P1_tag21_C11,8240,3684,1388,124,1313,41,1388,1313,2296,165
RNMB_Foping_BS_P1_tag21_C12,12982,6387,1612,149,1523,59,1612,1523,4775,208
RNMB_Foping_BS_P1_tag21_C1,1577,630,385,26,378,15,385,378,245,41
RNMB_Foping_BS_P1_tag21_C2,411,211,134,11,132,5,134,132,77,16
RNMB_Foping_BS_P1_tag21_C3,1375,611,356,27,340,14,356,340,255,41
RNMB_Foping_BS_P1_tag21_C4,1279,606,348,21,341,11,348,341,258,32
RNMB_Foping_BS_P1_tag21_C5,998,453,282,20,279,14,282,279,171,34
RNMB_Foping_BS_P1_tag21_C6,176,99,44,23,31,13,44,31,55,36
RNMB_Foping_BS_P1_tag21_C8,5212,2745,828,154,725,60,828,725,1917,214
RNMB_Foping_BS_P1_tag21_C9,6918,3221,757,134,694,63,757,694,2464,197
RNMB_Foping_BS_P1_tag21_D10,213,135,44,20,40,14,44,40,91,34
RNMB_Foping_BS_P1_tag21_D1,1909,793,478,23,471,12,478,471,315,35
RNMB_Foping_BS_P1_tag21_D2,86,47,32,3,31,2,32,31,15,5
RNMB_Foping_BS_P1_tag21_D3,660,320,205,12,201,7,205,201,115,19
RNMB_Foping_BS_P1_tag21_D4,1986,746,494,26,478,10,494,478,252,36
RNMB_Foping_BS_P1_tag21_D5,1354,633,343,27,330,12,343,330,290,39
RNMB_Foping_BS_P1_tag21_D6,81,56,37,23,31,17,37,31,19,40
RNMB_Foping_BS_P1_tag21_D7,1472,865,268,73,239,41,268,239,597,114
RNMB_Foping_BS_P1_tag21_D8,979,568,227,39,215,27,227,215,341,66
RNMB_Foping_BS_P1_tag21_E10,5248,2490,874,91,835,43,874,835,1616,134
RNMB_Foping_BS_P1_tag21_E11,5999,2955,1106,98,1057,43,1106,1057,1849,141
RNMB_Foping_BS_P1_tag21_E12,7887,3801,1508,121,1452,44,1508,1452,2293,165
RNMB_Foping_BS_P1_tag21_E1,285,138,89,8,88,6,89,88,49,14
RNMB_Foping_BS_P1_tag21_E2,67,41,32,6,31,5,32,31,9,11
RNMB_Foping_BS_P1_tag21_E3,805,395,230,24,223,11,230,223,165,35
RNMB_Foping_BS_P1_tag21_E4,541,327,187,14,184,8,187,184,140,22
RNMB_Foping_BS_P1_tag21_E5,15304,4294,1712,85,1627,24,1712,1627,2582,109
RNMB_Foping_BS_P1_tag21_E6,853,470,200,58,172,32,200,172,270,90
RNMB_Foping_BS_P1_tag21_E7,1985,943,291,87,245,44,291,245,652,131
RNMB_Foping_BS_P1_tag21_E8,5839,2839,725,103,675,44,725,675,2114,147
RNMB_Foping_BS_P1_tag21_F10,153,113,53,26,48,20,53,48,60,46
RNMB_Foping_BS_P1_tag21_F11,5647,2761,842,108,812,48,842,812,1919,156
RNMB_Foping_BS_P1_tag21_F12,1277,815,280,75,252,40,280,252,535,115
RNMB_Foping_BS_P1_tag21_F1,906,436,280,14,277,11,280,277,156,25
RNMB_Foping_BS_P1_tag21_F2,312,155,110,13,105,8,110,105,45,21
RNMB_Foping_BS_P1_tag21_F3,2712,1216,636,62,599,23,636,599,580,85
RNMB_Foping_BS_P1_tag21_F4,8109,2429,1141,62,1085,16,1141,1085,1288,78
RNMB_Foping_BS_P1_tag21_F5,4009,1393,778,43,750,16,778,750,615,59
RNMB_Foping_BS_P1_tag21_F6,403,275,129,54,99,24,129,99,146,78
RNMB_Foping_BS_P1_tag21_F8,9763,4776,1228,71,1151,31,1228,1151,3548,102
RNMB_Foping_BS_P1_tag21_F9,2777,1642,464,27,443,12,464,443,1178,39
RNMB_Foping_BS_P1_tag21_G10,788,448,143,46,124,26,143,124,305,72
RNMB_Foping_BS_P1_tag21_G11,20499,8027,2800,173,2701,68,2800,2701,5227,241
RNMB_Foping_BS_P1_tag21_G12,5007,2763,971,121,900,41,971,900,1792,162
RNMB_Foping_BS_P1_tag21_G1,595,292,215,19,208,11,215,208,77,30
RNMB_Foping_BS_P1_tag21_G2,180,108,67,5,64,2,67,64,41,7
RNMB_Foping_BS_P1_tag21_G3,975,505,275,25,254,7,275,254,230,32
RNMB_Foping_BS_P1_tag21_G4,10300,3291,1435,82,1351,16,1435,1351,1856,98
RNMB_Foping_BS_P1_tag21_G6,2240,1176,441,121,358,45,441,358,735,166
RNMB_Foping_BS_P1_tag21_G7,9692,4225,1241,126,1179,53,1241,1179,2984,179
RNMB_Foping_BS_P1_tag21_G8,20274,7920,2111,119,2023,41,2111,2023,5809,160
RNMB_Foping_BS_P1_tag21_G9,10662,4702,1134,34,1113,16,1134,1113,3568,50
RNMB_Foping_BS_P1_tag21_H10,19864,8694,2237,140,2145,40,2237,2145,6457,180
RNMB_Foping_BS_P1_tag21_H11,14834,7038,1900,192,1779,51,1900,1779,5138,243
RNMB_Foping_BS_P1_tag21_H12,1472,956,225,77,194,41,225,194,731,118
RNMB_Foping_BS_P1_tag21_H1,2019,879,513,36,497,12,513,497,366,48
RNMB_Foping_BS_P1_tag21_H2,563,308,183,14,177,7,183,177,125,21
RNMB_Foping_BS_P1_tag21_H3,5228,2221,1036,72,966,21,1036,966,1185,93
RNMB_Foping_BS_P1_tag21_H4,27918,8479,2544,173,2298,29,2544,2298,5935,202
RNMB_Foping_BS_P1_tag21_H5,9175,3189,1312,74,1236,16,1312,1236,1877,90
RNMB_Foping_BS_P1_tag21_H6,3301,1718,559,92,524,48,559,524,1159,140
RNMB_Foping_BS_P1_tag21_H7,2306,1340,355,103,287,35,355,287,985,138
RNMB_Foping_BS_P1_tag21_H8,7320,3887,1028,71,965,25,1028,965,2859,96
RNMB_Foping_BS_P1_tag21_H9,2316,1196,282,21,263,11,282,263,914,32
RNMB_Foping_BS_P2_tag24_A10,773,535,186,58,175,41,186,175,349,99
RNMB_Foping_BS_P2_tag24_A11,8729,4607,1227,143,1159,75,1227,1159,3380,218
RNMB_Foping_BS_P2_tag24_A12,8358,4777,1207,181,1102,79,1207,1102,3570,260
RNMB_Foping_BS_P2_tag24_A1,1680,1074,295,79,261,39,295,261,779,118
RNMB_Foping_BS_P2_tag24_A2,441,303,119,41,110,29,119,110,184,70
RNMB_Foping_BS_P2_tag24_A3,79744,31973,7152,365,6786,113,7152,6786,24821,478
RNMB_Foping_BS_P2_tag24_A4,22405,9484,3159,218,2999,81,3159,2999,6325,299
RNMB_Foping_BS_P2_tag24_A5,10398,5456,1772,224,1609,89,1772,1609,3684,313
RNMB_Foping_BS_P2_tag24_A6,137,116,57,34,47,24,57,47,59,58
RNMB_Foping_BS_P2_tag24_A7,25574,11646,2930,254,2777,91,2930,2777,8716,345
RNMB_Foping_BS_P2_tag24_A8,53,49,27,21,27,21,27,27,22,42
RNMB_Foping_BS_P2_tag24_A9,1054,595,223,42,217,36,223,217,372,78
RNMB_Foping_BS_P2_tag24_B10,96,85,44,31,43,27,44,43,41,58
RNMB_Foping_BS_P2_tag24_B11,100,81,40,31,32,22,40,32,41,53
RNMB_Foping_BS_P2_tag24_B12,902,609,167,66,155,50,167,155,442,116
RNMB_Foping_BS_P2_tag24_B1,1343,832,285,72,265,38,285,265,547,110
RNMB_Foping_BS_P2_tag24_B2,114,102,53,27,53,26,53,53,49,53
RNMB_Foping_BS_P2_tag24_B3,2044,1171,450,85,409,42,450,409,721,127
RNMB_Foping_BS_P2_tag24_B4,13609,6509,2060,172,1959,65,2060,1959,4449,237
RNMB_Foping_BS_P2_tag24_B5,595,456,182,50,165,30,182,165,274,80
RNMB_Foping_BS_P2_tag24_B6,79,67,36,25,34,24,36,34,31,49
RNMB_Foping_BS_P2_tag24_B7,11771,5275,1850,137,1808,77,1850,1808,3425,214
RNMB_Foping_BS_P2_tag24_B8,6396,3114,871,87,842,55,871,842,2243,142
RNMB_Foping_BS_P2_tag24_B9,172,141,43,23,41,21,43,41,98,44
RNMB_Foping_BS_P2_tag24_C10,529,348,142,61,134,45,142,134,206,106
RNMB_Foping_BS_P2_tag24_C11,11391,5569,1629,156,1463,77,1629,1463,3940,233
RNMB_Foping_BS_P2_tag24_C12,11009,5095,1165,108,1116,64,1165,1116,3930,172
RNMB_Foping_BS_P2_tag24_C1,410,259,116,30,112,26,116,112,143,56
RNMB_Foping_BS_P2_tag24_C2,82,70,35,21,32,18,35,32,35,39
RNMB_Foping_BS_P2_tag24_C3,406,253,104,32,97,23,104,97,149,55
RNMB_Foping_BS_P2_tag24_C4,148,104,57,19,52,12,57,52,47,31
RNMB_Foping_BS_P2_tag24_C5,163,126,64,27,60,23,64,60,62,50
RNMB_Foping_BS_P2_tag24_C6,379,252,128,30,120,21,128,120,124,51
RNMB_Foping_BS_P2_tag24_C7,19827,8836,2268,165,2193,74,2268,2193,6568,239
RNMB_Foping_BS_P2_tag24_C8,7439,3868,1158,140,1099,66,1158,1099,2710,206
RNMB_Foping_BS_P2_tag24_C9,4011,2109,693,82,676,56,693,676,1416,138
RNMB_Foping_BS_P2_tag24_D10,295,199,64,29,59,22,64,59,135,51
RNMB_Foping_BS_P2_tag24_D11,21896,10459,2400,245,2289,108,2400,2289,8059,353
RNMB_Foping_BS_P2_tag24_D1,291,204,81,36,75,26,81,75,123,62
RNMB_Foping_BS_P2_tag24_D2,71,65,34,16,33,14,34,33,31,30
RNMB_Foping_BS_P2_tag24_D3,109,97,45,20,43,17,45,43,52,37
RNMB_Foping_BS_P2_tag24_D4,300,196,95,35,83,19,95,83,101,54
RNMB_Foping_BS_P2_tag24_D5,227,176,95,30,89,23,95,89,81,53
RNMB_Foping_BS_P2_tag24_D6,97,71,31,10,31,10,31,31,40,20
RNMB_Foping_BS_P2_tag24_D7,1201,715,273,72,240,38,273,240,442,110
RNMB_Foping_BS_P2_tag24_D8,1014,670,156,43,138,26,156,138,514,69
RNMB_Foping_BS_P2_tag24_D9,14860,6908,1984,177,1842,81,1984,1842,4924,258
RNMB_Foping_BS_P2_tag24_E10,3709,2068,655,110,608,63,655,608,1413,173
RNMB_Foping_BS_P2_tag24_E11,5572,3288,622,128,578,69,622,578,2666,197
RNMB_Foping_BS_P2_tag24_E12,5867,3569,886,172,820,97,886,820,2683,269
RNMB_Foping_BS_P2_tag24_E1,79,64,32,20,31,18,32,31,32,38
RNMB_Foping_BS_P2_tag24_E2,50,43,27,17,26,15,27,26,16,32
RNMB_Foping_BS_P2_tag24_E3,154,120,64,26,56,17,64,56,56,43
RNMB_Foping_BS_P2_tag24_E4,164,139,63,29,56,19,63,56,76,48
RNMB_Foping_BS_P2_tag24_E5,10821,5315,1809,169,1714,69,1809,1714,3506,238
RNMB_Foping_BS_P2_tag24_E6,603,419,132,56,113,38,132,113,287,94
RNMB_Foping_BS_P2_tag24_E7,2618,1405,562,85,520,43,562,520,843,128
RNMB_Foping_BS_P2_tag24_E8,7523,3710,854,104,814,58,854,814,2856,162
RNMB_Foping_BS_P2_tag24_E9,11979,5231,1396,129,1352,72,1396,1352,3835,201
RNMB_Foping_BS_P2_tag24_F10,145,113,47,22,41,16,47,41,66,38
RNMB_Foping_BS_P2_tag24_F11,21797,10697,2604,255,2434,107,2604,2434,8093,362
RNMB_Foping_BS_P2_tag24_F12,1478,1046,304,67,282,44,304,282,742,111
RNMB_Foping_BS_P2_tag24_F1,170,140,59,18,55,14,59,55,81,32
RNMB_Foping_BS_P2_tag24_F2,149,112,53,27,46,19,53,46,59,46
RNMB_Foping_BS_P2_tag24_F3,1104,618,244,64,218,35,244,218,374,99
RNMB_Foping_BS_P2_tag24_F4,1489,912,304,63,278,32,304,278,608,95
RNMB_Foping_BS_P2_tag24_F5,2729,1336,470,59,447,33,470,447,866,92
RNMB_Foping_BS_P2_tag24_F6,1250,502,113,38,88,24,113,88,389,62
RNMB_Foping_BS_P2_tag24_F7,7794,3832,947,110,907,62,947,907,2885,172
RNMB_Foping_BS_P2_tag24_F8,8389,4554,1364,177,1283,90,1364,1283,3190,267
RNMB_Foping_BS_P2_tag24_F9,2442,1492,445,85,420,46,445,420,1047,131
RNMB_Foping_BS_P2_tag24_G10,653,379,101,48,82,31,101,82,278,79
RNMB_Foping_BS_P2_tag24_G11,33445,14947,3791,252,3642,117,3791,3642,11156,369
RNMB_Foping_BS_P2_tag24_G12,5896,3507,858,147,775,71,858,775,2649,218
RNMB_Foping_BS_P2_tag24_G1,141,113,57,30,53,25,57,53,56,55
RNMB_Foping_BS_P2_tag24_G2,87,66,37,19,37,19,37,37,29,38
RNMB_Foping_BS_P2_tag24_G3,219,161,84,30,74,22,84,74,77,52
RNMB_Foping_BS_P2_tag24_G4,3859,2096,768,101,680,42,768,680,1328,143
RNMB_Foping_BS_P2_tag24_G5,561,325,152,31,135,14,152,135,173,45
RNMB_Foping_BS_P2_tag24_G6,3119,1643,608,99,555,50,608,555,1035,149
RNMB_Foping_BS_P2_tag24_G7,4123,2407,652,93,613,55,652,613,1755,148
RNMB_Foping_BS_P2_tag24_G8,14957,7111,1667,186,1587,100,1667,1587,5444,286
RNMB_Foping_BS_P2_tag24_G9,20126,8965,2547,195,2464,96,2547,2464,6418,291
RNMB_Foping_BS_P2_tag24_H10,12503,7055,1343,177,1258,84,1343,1258,5712,261
RNMB_Foping_BS_P2_tag24_H11,14678,7544,2048,182,1977,93,2048,1977,5496,275
RNMB_Foping_BS_P2_tag24_H12,1619,1123,281,82,231,37,281,231,842,119
RNMB_Foping_BS_P2_tag24_H2,109,84,47,21,43,18,47,43,37,39
RNMB_Foping_BS_P2_tag24_H3,1659,962,286,55,269,35,286,269,676,90
RNMB_Foping_BS_P2_tag24_H4,8844,4326,1460,160,1374,62,1460,1374,2866,222
RNMB_Foping_BS_P2_tag24_H5,2103,1278,343,65,306,29,343,306,935,94
RNMB_Foping_BS_P2_tag24_H6,7868,4481,905,138,844,66,905,844,3576,204
RNMB_Foping_BS_P2_tag24_H7,2813,1567,524,83,491,38,524,491,1043,121
RNMB_Foping_BS_P2_tag24_H8,5653,2882,771,117,685,67,771,685,2111,184
RNMB_Foping_BS_P2_tag24_H9,1551,1023,278,82,259,56,278,259,745,138
RNMB_Foping_BS_P3_tag26_A10,611,411,43,19,37,12,43,37,368,31
RNMB_Foping_BS_P3_tag26_A11,1278,722,304,57,269,20,304,269,418,77
RNMB_Foping_BS_P3_tag26_A12,3022,1454,528,48,491,19,528,491,926,67
RNMB_Foping_BS_P3_tag26_A1,241,168,52,19,48,15,52,48,116,34
RNMB_Foping_BS_P3_tag26_A2,24,22,10,8,9,7,10,9,12,15
RNMB_Foping_BS_P3_tag26_A3,5735,2559,485,45,447,18,485,447,2074,63
RNMB_Foping_BS_P3_tag26_A4,2000,747,232,27,95,11,232,95,515,38
RNMB_Foping_BS_P3_tag26_A5,5012,2108,497,54,463,25,497,463,1611,79
RNMB_Foping_BS_P3_tag26_A6,65,56,18,10,14,7,18,14,38,17
RNMB_Foping_BS_P3_tag26_A7,4402,1773,332,47,307,20,332,307,1441,67
RNMB_Foping_BS_P3_tag26_A8,20,18,6,6,4,4,6,4,12,10
RNMB_Foping_BS_P3_tag26_A9,312,191,35,18,28,11,35,28,156,29
RNMB_Foping_BS_P3_tag26_B10,10,10,3,3,3,3,3,3,7,6
RNMB_Foping_BS_P3_tag26_B11,21,17,12,10,9,7,12,9,5,17
RNMB_Foping_BS_P3_tag26_B12,475,285,107,23,94,10,107,94,178,33
RNMB_Foping_BS_P3_tag26_B1,284,217,45,26,41,21,45,41,172,47
RNMB_Foping_BS_P3_tag26_B3,280,147,71,31,49,17,71,49,76,48
RNMB_Foping_BS_P3_tag26_B2,11,11,6,5,6,5,6,6,5,10
RNMB_Foping_BS_P3_tag26_B4,1280,648,108,47,85,24,108,85,540,71
RNMB_Foping_BS_P3_tag26_B5,363,175,23,10,19,6,23,19,152,16
RNMB_Foping_BS_P3_tag26_B6,23,19,5,4,5,4,5,5,14,8
RNMB_Foping_BS_P3_tag26_B8,1802,766,138,28,104,8,138,104,628,36
RNMB_Foping_BS_P3_tag26_B9,153,62,17,7,11,5,17,11,45,12
RNMB_Foping_BS_P3_tag26_C10,107,79,31,17,28,13,31,28,48,30
RNMB_Foping_BS_P3_tag26_C11,1298,679,142,54,94,25,142,94,537,79
RNMB_Foping_BS_P3_tag26_C12,1745,923,349,58,312,21,349,312,574,79
RNMB_Foping_BS_P3_tag26_C1,97,71,20,14,15,9,20,15,51,23
RNMB_Foping_BS_P3_tag26_C2,9,9,3,3,1,1,3,1,6,4
RNMB_Foping_BS_P3_tag26_C3,134,52,33,14,19,5,33,19,19,19
RNMB_Foping_BS_P3_tag26_C4,6,5,2,2,1,1,2,1,3,3
RNMB_Foping_BS_P3_tag26_C5,60,42,14,10,11,7,14,11,28,17
RNMB_Foping_BS_P3_tag26_C6,229,144,21,11,15,6,21,15,123,17
RNMB_Foping_BS_P3_tag26_C7,18624,5681,1190,31,1160,9,1190,1160,4491,40
RNMB_Foping_BS_P3_tag26_C8,2384,1049,323,46,290,20,323,290,726,66
RNMB_Foping_BS_P3_tag26_C9,1441,572,200,36,148,22,200,148,372,58
RNMB_Foping_BS_P3_tag26_D10,69,39,14,13,12,11,14,12,25,24
RNMB_Foping_BS_P3_tag26_D11,3209,1515,567,98,501,34,567,501,948,132
RNMB_Foping_BS_P3_tag26_D12,2337,1322,402,67,361,30,402,361,920,97
RNMB_Foping_BS_P3_tag26_D1,30,28,5,5,4,4,5,4,23,9
RNMB_Foping_BS_P3_tag26_D2,6,5,3,3,3,3,3,3,2,6
RNMB_Foping_BS_P3_tag26_D3,137,57,34,9,11,4,34,11,23,13
RNMB_Foping_BS_P3_tag26_D4,29,19,6,5,3,2,6,3,13,7
RNMB_Foping_BS_P3_tag26_D5,86,62,17,9,11,4,17,11,45,13
RNMB_Foping_BS_P3_tag26_D7,1675,694,234,19,208,8,234,208,460,27
RNMB_Foping_BS_P3_tag26_D6,2,2,1,1,1,1,1,1,1,2
RNMB_Foping_BS_P3_tag26_D8,72,43,17,9,13,5,17,13,26,14
RNMB_Foping_BS_P3_tag26_D9,1797,912,204,41,183,20,204,183,708,61
RNMB_Foping_BS_P3_tag26_E10,1240,691,188,49,168,21,188,168,503,70
RNMB_Foping_BS_P3_tag26_E11,1233,640,186,32,172,17,186,172,454,49
RNMB_Foping_BS_P3_tag26_E12,1634,880,227,35,213,18,227,213,653,53
RNMB_Foping_BS_P3_tag26_E1,18,18,9,7,9,7,9,9,9,14
RNMB_Foping_BS_P3_tag26_E3,55,40,13,9,12,8,13,12,27,17
RNMB_Foping_BS_P3_tag26_E2,10,8,4,3,3,2,4,3,4,5
RNMB_Foping_BS_P3_tag26_E4,13,11,7,6,3,2,7,3,4,8
RNMB_Foping_BS_P3_tag26_E5,432,188,50,34,25,14,50,25,138,48
RNMB_Foping_BS_P3_tag26_E6,194,147,42,14,36,8,42,36,105,22
RNMB_Foping_BS_P3_tag26_E7,1929,829,245,27,223,9,245,223,584,36
RNMB_Foping_BS_P3_tag26_E8,1208,597,163,39,140,14,163,140,434,53
RNMB_Foping_BS_P3_tag26_E9,3525,1505,350,58,318,25,350,318,1155,83
RNMB_Foping_BS_P3_tag26_F10,20,18,10,5,9,4,10,9,8,9
RNMB_Foping_BS_P3_tag26_F11,4277,1968,712,87,643,26,712,643,1256,113
RNMB_Foping_BS_P3_tag26_F12,1133,551,165,30,151,15,165,151,386,45
RNMB_Foping_BS_P3_tag26_F1,44,37,12,9,11,8,12,11,25,17
RNMB_Foping_BS_P3_tag26_F2,20,15,8,7,6,5,8,6,7,12
RNMB_Foping_BS_P3_tag26_F3,3811,474,169,25,28,8,169,28,305,33
RNMB_Foping_BS_P3_tag26_F4,81,43,20,20,6,6,20,6,23,26
RNMB_Foping_BS_P3_tag26_F5,205,121,32,20,19,8,32,19,89,28
RNMB_Foping_BS_P3_tag26_F6,10,9,5,4,5,4,5,5,4,8
RNMB_Foping_BS_P3_tag26_F7,2790,1057,314,42,257,8,314,257,743,50
RNMB_Foping_BS_P3_tag26_F8,1911,854,213,47,192,22,213,192,641,69
RNMB_Foping_BS_P3_tag26_F9,2209,432,150,32,60,10,150,60,282,42
RNMB_Foping_BS_P3_tag26_G10,108,80,38,13,29,4,38,29,42,17
RNMB_Foping_BS_P3_tag26_G11,6145,2650,874,88,804,29,874,804,1776,117
RNMB_Foping_BS_P3_tag26_G12,1060,591,196,60,143,18,196,143,395,78
RNMB_Foping_BS_P3_tag26_G1,21,16,10,7,8,5,10,8,6,12
RNMB_Foping_BS_P3_tag26_G2,20,13,6,5,4,3,6,4,7,8
RNMB_Foping_BS_P3_tag26_G3,66,38,26,16,18,7,26,18,12,23
RNMB_Foping_BS_P3_tag26_G4,202,108,34,22,20,9,34,20,74,31
RNMB_Foping_BS_P3_tag26_G5,71,46,25,11,18,4,25,18,21,15
RNMB_Foping_BS_P3_tag26_G6,1010,289,97,56,24,11,97,24,192,67
RNMB_Foping_BS_P3_tag26_G7,6823,2981,601,33,581,13,601,581,2380,46
RNMB_Foping_BS_P3_tag26_G8,1963,826,304,34,289,15,304,289,522,49
RNMB_Foping_BS_P3_tag26_G9,783,424,89,54,49,20,89,49,335,74
RNMB_Foping_BS_P3_tag26_H10,3040,1552,561,56,530,23,561,530,991,79
RNMB_Foping_BS_P3_tag26_H11,5347,2200,579,93,503,28,579,503,1621,121
RNMB_Foping_BS_P3_tag26_H12,670,351,114,34,92,15,114,92,237,49
RNMB_Foping_BS_P3_tag26_H1,43,36,12,8,11,7,12,11,24,15
RNMB_Foping_BS_P3_tag26_H2,45,32,18,8,17,7,18,17,14,15
RNMB_Foping_BS_P3_tag26_H3,262,156,48,18,32,11,48,32,108,29
RNMB_Foping_BS_P3_tag26_H4,1537,778,184,52,135,10,184,135,594,62
RNMB_Foping_BS_P3_tag26_H5,250,141,15,7,11,3,15,11,126,10
RNMB_Foping_BS_P3_tag26_H6,1374,668,223,35,208,19,223,208,445,54
RNMB_Foping_BS_P3_tag26_H7,2266,1022,275,17,268,10,275,268,747,27
RNMB_Foping_BS_P3_tag26_H8,547,274,76,23,65,12,76,65,198,35
RNMB_Foping_BS_P3_tag26_H9,135,97,34,24,16,10,34,16,63,34
RNMB_meicity_BS_P1_tag41_A10,1208,605,184,27,170,13,184,170,421,40
RNMB_meicity_BS_P1_tag41_A11,1841,593,171,41,87,25,171,87,422,66
RNMB_meicity_BS_P1_tag41_A12,2310,1149,213,54,177,21,213,177,936,75
RNMB_meicity_BS_P1_tag41_A1,15,15,5,3,5,3,5,5,10,6
RNMB_meicity_BS_P1_tag41_A2,26,20,8,6,8,6,8,8,12,12
RNMB_meicity_BS_P1_tag41_A3,1164,658,72,26,63,17,72,63,586,43
RNMB_meicity_BS_P1_tag41_A4,1093,653,137,39,110,16,137,110,516,55
RNMB_meicity_BS_P1_tag41_A5,2540,1241,502,68,448,21,502,448,739,89
RNMB_meicity_BS_P1_tag41_A6,92,58,26,15,16,5,26,16,32,20
RNMB_meicity_BS_P1_tag41_A7,1281,707,203,110,113,27,203,113,504,137
RNMB_meicity_BS_P1_tag41_A8,9,8,5,5,3,3,5,3,3,8
RNMB_meicity_BS_P1_tag41_A9,48,41,12,11,8,7,12,8,29,18
RNMB_meicity_BS_P1_tag41_B10,18,18,8,6,7,5,8,7,10,11
RNMB_meicity_BS_P1_tag41_B11,23,17,9,6,2,2,9,2,8,8
RNMB_meicity_BS_P1_tag41_B12,66,55,29,23,14,9,29,14,26,32
RNMB_meicity_BS_P1_tag41_B1,174,101,11,5,9,4,11,9,90,9
RNMB_meicity_BS_P1_tag41_B3,78,63,16,15,9,8,16,9,47,23
RNMB_meicity_BS_P1_tag41_B2,7,7,3,3,3,3,3,3,4,6
RNMB_meicity_BS_P1_tag41_B4,604,363,107,48,69,15,107,69,256,63
RNMB_meicity_BS_P1_tag41_B5,92,55,23,17,12,6,23,12,32,23
RNMB_meicity_BS_P1_tag41_B6,11,11,7,6,7,6,7,7,4,12
RNMB_meicity_BS_P1_tag41_B7,6339,2133,653,39,629,18,653,629,1480,57
RNMB_meicity_BS_P1_tag41_B8,1122,585,148,68,100,26,148,100,437,94
RNMB_meicity_BS_P1_tag41_B9,10,10,6,4,5,3,6,5,4,7
RNMB_meicity_BS_P1_tag41_C10,493,318,50,12,47,9,50,47,268,21
RNMB_meicity_BS_P1_tag41_C11,749,350,91,33,60,15,91,60,259,48
RNMB_meicity_BS_P1_tag41_C12,948,506,69,20,57,11,69,57,437,31
RNMB_meicity_BS_P1_tag41_C1,5,5,3,2,3,2,3,3,2,4
RNMB_meicity_BS_P1_tag41_C2,12,11,5,4,5,4,5,5,6,8
RNMB_meicity_BS_P1_tag41_C3,23,19,4,2,3,1,4,3,15,3
RNMB_meicity_BS_P1_tag41_C4,11,11,7,5,5,3,7,5,4,8
RNMB_meicity_BS_P1_tag41_C5,21,21,7,7,3,3,7,3,14,10
RNMB_meicity_BS_P1_tag41_C6,32,26,13,11,9,7,13,9,13,18
RNMB_meicity_BS_P1_tag41_C7,2006,1007,451,59,415,23,451,415,556,82
RNMB_meicity_BS_P1_tag41_C8,450,254,117,31,103,18,117,103,137,49
RNMB_meicity_BS_P1_tag41_C9,997,509,111,30,98,18,111,98,398,48
RNMB_meicity_BS_P1_tag41_D10,137,79,23,7,23,6,23,23,56,13
RNMB_meicity_BS_P1_tag41_D11,2161,933,307,50,277,24,307,277,626,74
RNMB_meicity_BS_P1_tag41_D12,1970,1044,185,42,165,22,185,165,859,64
RNMB_meicity_BS_P1_tag41_D1,7,6,1,1,1,1,1,1,5,2
RNMB_meicity_BS_P1_tag41_D3,55,43,12,12,0,0,12,0,31,12
RNMB_meicity_BS_P1_tag41_D2,8,8,6,5,6,5,6,6,2,10
RNMB_meicity_BS_P1_tag41_D4,183,83,19,8,16,5,19,16,64,13
RNMB_meicity_BS_P1_tag41_D5,21,18,12,8,10,6,12,10,6,14
RNMB_meicity_BS_P1_tag41_D6,21,12,9,9,2,2,9,2,3,11
RNMB_meicity_BS_P1_tag41_D7,169,111,54,23,41,12,54,41,57,35
RNMB_meicity_BS_P1_tag41_D8,109,74,30,18,21,8,30,21,44,26
RNMB_meicity_BS_P1_tag41_D9,1239,654,156,66,116,29,156,116,498,95
RNMB_meicity_BS_P1_tag41_E10,172,135,32,21,17,6,32,17,103,27
RNMB_meicity_BS_P1_tag41_E11,455,239,77,26,55,11,77,55,162,37
RNMB_meicity_BS_P1_tag41_E12,1338,771,182,35,162,17,182,162,589,52
RNMB_meicity_BS_P1_tag41_E3,12,12,6,6,3,3,6,3,6,9
RNMB_meicity_BS_P1_tag41_E1,2,2,0,0,0,0,0,0,2,0
RNMB_meicity_BS_P1_tag41_E4,20,19,11,9,7,5,11,7,8,14
RNMB_meicity_BS_P1_tag41_E2,3,3,2,1,2,1,2,2,1,2
RNMB_meicity_BS_P1_tag41_E5,657,388,167,85,88,15,167,88,221,100
RNMB_meicity_BS_P1_tag41_E6,99,70,32,27,11,7,32,11,38,34
RNMB_meicity_BS_P1_tag41_E7,146,109,41,14,38,10,41,38,68,24
RNMB_meicity_BS_P1_tag41_E8,341,240,98,44,71,18,98,71,142,62
RNMB_meicity_BS_P1_tag41_E9,616,368,140,68,82,15,140,82,228,83
RNMB_meicity_BS_P1_tag41_F10,93,52,14,8,12,6,14,12,38,14
RNMB_meicity_BS_P1_tag41_F11,486,279,101,32,82,16,101,82,178,48
RNMB_meicity_BS_P1_tag41_F12,317,176,65,27,48,11,65,48,111,38
RNMB_meicity_BS_P1_tag41_F3,127,81,27,18,15,6,27,15,54,24
RNMB_meicity_BS_P1_tag41_F1,11,11,1,1,1,1,1,1,10,2
RNMB_meicity_BS_P1_tag41_F2,5,5,2,2,2,2,2,2,3,4
RNMB_meicity_BS_P1_tag41_F4,87,74,42,30,19,7,42,19,32,37
RNMB_meicity_BS_P1_tag41_F5,134,95,54,47,9,5,54,9,41,52
RNMB_meicity_BS_P1_tag41_F6,221,130,49,29,29,8,49,29,81,37
RNMB_meicity_BS_P1_tag41_F7,681,398,108,41,74,14,108,74,290,55
RNMB_meicity_BS_P1_tag41_F8,610,352,106,44,76,17,106,76,246,61
RNMB_meicity_BS_P1_tag41_F9,408,263,107,60,68,25,107,68,156,85
RNMB_meicity_BS_P1_tag41_G10,172,94,29,15,25,11,29,25,65,26
RNMB_meicity_BS_P1_tag41_G11,4218,1776,480,76,434,27,480,434,1296,103
RNMB_meicity_BS_P1_tag41_G12,2159,1178,203,40,180,19,203,180,975,59
RNMB_meicity_BS_P1_tag41_G3,10,10,4,4,2,2,4,2,6,6
RNMB_meicity_BS_P1_tag41_G4,538,311,115,62,62,13,115,62,196,75
RNMB_meicity_BS_P1_tag41_G1,5,5,2,2,2,2,2,2,3,4
RNMB_meicity_BS_P1_tag41_G2,4,4,0,0,0,0,0,0,4,0
RNMB_meicity_BS_P1_tag41_G5,54,37,24,22,7,5,24,7,13,27
RNMB_meicity_BS_P1_tag41_G6,424,258,114,79,40,11,114,40,144,90
RNMB_meicity_BS_P1_tag41_G7,1786,920,201,37,181,18,201,181,719,55
RNMB_meicity_BS_P1_tag41_G8,1218,636,230,60,190,20,230,190,406,80
RNMB_meicity_BS_P1_tag41_G9,6630,3136,584,59,532,11,584,532,2552,70
RNMB_meicity_BS_P1_tag41_H10,2898,1419,225,50,147,23,225,147,1194,73
RNMB_meicity_BS_P1_tag41_H11,3273,1553,350,52,314,17,350,314,1203,69
RNMB_meicity_BS_P1_tag41_H12,370,238,78,33,58,16,78,58,160,49
RNMB_meicity_BS_P1_tag41_H1,27,23,11,6,10,5,11,10,12,11
RNMB_meicity_BS_P1_tag41_H3,58,51,23,16,15,8,23,15,28,24
RNMB_meicity_BS_P1_tag41_H2,6,5,2,2,2,2,2,2,3,4
RNMB_meicity_BS_P1_tag41_H4,1117,627,208,94,130,20,208,130,419,114
RNMB_meicity_BS_P1_tag41_H5,211,140,63,42,29,11,63,29,77,53
RNMB_meicity_BS_P1_tag41_H6,1599,904,309,84,247,27,309,247,595,111
RNMB_meicity_BS_P1_tag41_H7,213,150,78,53,34,15,78,34,72,68
RNMB_meicity_BS_P1_tag41_H8,449,220,78,30,63,13,78,63,142,43
RNMB_meicity_BS_P1_tag41_H9,529,314,100,16,94,9,100,94,214,25
RNMB_meicity_BS_P2_tag42_A10,494,297,142,25,135,17,142,135,155,42
RNMB_meicity_BS_P2_tag42_A11,6169,2999,1084,72,1000,28,1084,1000,1915,100
RNMB_meicity_BS_P2_tag42_A12,3280,1933,556,66,496,25,556,496,1377,91
RNMB_meicity_BS_P2_tag42_A1,843,432,174,20,171,17,174,171,258,37
RNMB_meicity_BS_P2_tag42_A2,111,79,37,12,37,12,37,37,42,24
RNMB_meicity_BS_P2_tag42_A3,24881,9512,2553,156,2471,69,2553,2471,6959,225
RNMB_meicity_BS_P2_tag42_A4,21863,7037,2023,116,1937,49,2023,1937,5014,165
RNMB_meicity_BS_P2_tag42_A5,1596,957,221,72,180,38,221,180,736,110
RNMB_meicity_BS_P2_tag42_A6,23,18,9,6,8,5,9,8,9,11
RNMB_meicity_BS_P2_tag42_A8,9,9,5,4,5,4,5,5,4,8
RNMB_meicity_BS_P2_tag42_A9,243,143,37,17,35,15,37,35,106,32
RNMB_meicity_BS_P2_tag42_B10,41,38,23,12,22,11,23,22,15,23
RNMB_meicity_BS_P2_tag42_B11,233,148,84,14,81,11,84,81,64,25
RNMB_meicity_BS_P2_tag42_B12,899,576,169,45,143,24,169,143,407,69
RNMB_meicity_BS_P2_tag42_B1,805,443,216,30,213,26,216,213,227,56
RNMB_meicity_BS_P2_tag42_B2,37,26,14,7,14,7,14,14,12,14
RNMB_meicity_BS_P2_tag42_B4,10819,4635,1570,102,1528,48,1570,1528,3065,150
RNMB_meicity_BS_P2_tag42_B5,480,285,77,25,70,18,77,70,208,43
RNMB_meicity_BS_P2_tag42_B6,16,16,8,5,8,5,8,8,8,10
RNMB_meicity_BS_P2_tag42_B7,9122,4010,825,134,730,52,825,730,3185,186
RNMB_meicity_BS_P2_tag42_B8,4198,1620,662,56,640,28,662,640,958,84
RNMB_meicity_BS_P2_tag42_B9,15,14,7,7,6,6,7,6,7,13
RNMB_meicity_BS_P2_tag42_C10,1001,464,261,34,244,19,261,244,203,53
RNMB_meicity_BS_P2_tag42_C11,11215,4995,1975,124,1873,36,1975,1873,3020,160
RNMB_meicity_BS_P2_tag42_C12,16525,5330,1949,106,1797,43,1949,1797,3381,149
RNMB_meicity_BS_P2_tag42_C1,798,345,191,15,188,12,191,188,154,27
RNMB_meicity_BS_P2_tag42_C2,49,28,19,9,17,7,19,17,9,16
RNMB_meicity_BS_P2_tag42_C3,262,178,76,27,71,19,76,71,102,46
RNMB_meicity_BS_P2_tag42_C4,300,173,89,17,85,9,89,85,84,26
RNMB_meicity_BS_P2_tag42_C6,31,24,11,7,9,5,11,9,13,12
RNMB_meicity_BS_P2_tag42_C7,7449,3428,820,148,743,55,820,743,2608,203
RNMB_meicity_BS_P2_tag42_C8,5997,2167,804,51,785,29,804,785,1363,80
RNMB_meicity_BS_P2_tag42_C9,4565,1992,452,60,423,29,452,423,1540,89
RNMB_meicity_BS_P2_tag42_D10,506,268,138,16,133,10,138,133,130,26
RNMB_meicity_BS_P2_tag42_D11,14844,5959,2113,129,1997,42,2113,1997,3846,171
RNMB_meicity_BS_P2_tag42_D12,12802,5832,1377,111,1269,31,1377,1269,4455,142
RNMB_meicity_BS_P2_tag42_D1,645,374,111,24,107,16,111,107,263,40
RNMB_meicity_BS_P2_tag42_D2,15,14,11,10,11,9,11,11,3,19
RNMB_meicity_BS_P2_tag42_D3,217,142,65,17,62,13,65,62,77,30
RNMB_meicity_BS_P2_tag42_D4,666,352,164,26,158,13,164,158,188,39
RNMB_meicity_BS_P2_tag42_D5,87,63,25,20,19,15,25,19,38,35
RNMB_meicity_BS_P2_tag42_D6,21,18,7,6,5,4,7,5,11,10
RNMB_meicity_BS_P2_tag42_D7,337,205,65,30,56,17,65,56,140,47
RNMB_meicity_BS_P2_tag42_D8,264,160,36,20,32,17,36,32,124,37
RNMB_meicity_BS_P2_tag42_D9,3172,1311,303,33,296,25,303,296,1008,58
RNMB_meicity_BS_P2_tag42_E10,6638,2951,1454,73,1396,32,1454,1396,1497,105
RNMB_meicity_BS_P2_tag42_E11,5461,2241,981,48,924,19,981,924,1260,67
RNMB_meicity_BS_P2_tag42_E12,2915,1878,485,92,414,30,485,414,1393,122
RNMB_meicity_BS_P2_tag42_E1,64,39,22,8,22,8,22,22,17,16
RNMB_meicity_BS_P2_tag42_E2,22,21,14,11,13,10,14,13,7,21
RNMB_meicity_BS_P2_tag42_E3,997,341,133,25,64,12,133,64,208,37
RNMB_meicity_BS_P2_tag42_E4,60,44,9,7,7,5,9,7,35,12
RNMB_meicity_BS_P2_tag42_E5,4646,2306,430,83,369,40,430,369,1876,123
RNMB_meicity_BS_P2_tag42_E6,124,76,35,16,30,11,35,30,41,27
RNMB_meicity_BS_P2_tag42_E7,2522,955,456,20,449,11,456,449,499,31
RNMB_meicity_BS_P2_tag42_E8,1287,680,84,22,71,16,84,71,596,38
RNMB_meicity_BS_P2_tag42_F10,292,166,86,17,80,11,86,80,80,28
RNMB_meicity_BS_P2_tag42_F11,4985,2761,541,83,481,29,541,481,2220,112
RNMB_meicity_BS_P2_tag42_F12,648,444,137,34,122,16,137,122,307,50
RNMB_meicity_BS_P2_tag42_F1,149,110,55,17,52,13,55,52,55,30
RNMB_meicity_BS_P2_tag42_F2,64,45,30,13,28,11,30,28,15,24
RNMB_meicity_BS_P2_tag42_F3,2478,1075,556,44,537,20,556,537,519,64
RNMB_meicity_BS_P2_tag42_F4,826,424,171,35,159,21,171,159,253,56
RNMB_meicity_BS_P2_tag42_F5,224,156,48,33,27,13,48,27,108,46
RNMB_meicity_BS_P2_tag42_F6,126,87,53,24,41,14,53,41,34,38
RNMB_meicity_BS_P2_tag42_F7,4081,1720,696,56,664,24,696,664,1024,80
RNMB_meicity_BS_P2_tag42_F8,2585,1199,327,42,320,33,327,320,872,75
RNMB_meicity_BS_P2_tag42_F9,1661,540,257,42,174,20,257,174,283,62
RNMB_meicity_BS_P2_tag42_G10,1204,602,323,30,303,17,323,303,279,47
RNMB_meicity_BS_P2_tag42_G11,10841,5234,1212,158,1072,42,1212,1072,4022,200
RNMB_meicity_BS_P2_tag42_G12,1940,1168,232,50,206,22,232,206,936,72
RNMB_meicity_BS_P2_tag42_G1,242,143,79,14,79,13,79,79,64,27
RNMB_meicity_BS_P2_tag42_G2,43,34,21,13,20,12,21,20,13,25
RNMB_meicity_BS_P2_tag42_G3,165,116,59,20,51,16,59,51,57,36
RNMB_meicity_BS_P2_tag42_G4,803,451,107,59,74,25,107,74,344,84
RNMB_meicity_BS_P2_tag42_G5,51,35,22,16,15,9,22,15,13,25
RNMB_meicity_BS_P2_tag42_G6,662,386,142,54,108,24,142,108,244,78
RNMB_meicity_BS_P2_tag42_G7,6941,2235,873,32,857,18,873,857,1362,50
RNMB_meicity_BS_P2_tag42_G8,2929,1351,265,41,247,23,265,247,1086,64
RNMB_meicity_BS_P2_tag42_G9,3715,1687,728,72,685,39,728,685,959,111
RNMB_meicity_BS_P2_tag42_H10,10033,5001,1622,105,1513,29,1622,1513,3379,134
RNMB_meicity_BS_P2_tag42_H11,4857,2609,749,88,667,26,749,667,1860,114
RNMB_meicity_BS_P2_tag42_H12,91,64,23,15,18,10,23,18,41,25
RNMB_meicity_BS_P2_tag42_H1,366,184,110,7,108,5,110,108,74,12
RNMB_meicity_BS_P2_tag42_H2,82,50,27,10,25,8,27,25,23,18
RNMB_meicity_BS_P2_tag42_H3,3964,1492,480,49,374,21,480,374,1012,70
RNMB_meicity_BS_P2_tag42_H4,3589,1907,375,79,328,35,375,328,1532,114
RNMB_meicity_BS_P2_tag42_H5,304,183,79,16,74,11,79,74,104,27
RNMB_meicity_BS_P2_tag42_H6,642,377,124,37,107,20,124,107,253,57
RNMB_meicity_BS_P2_tag42_H7,1761,862,384,27,374,13,384,374,478,40
RNMB_meicity_BS_P2_tag42_H8,525,295,74,20,67,13,74,67,221,33
RNMB_meicity_BS_P2_tag42_H9,142,94,47,18,44,15,47,44,47,33
RNMB_Mix_BS_PIX_tag34_A1,686,438,85,33,66,12,85,66,353,45
RNMB_Mix_BS_PIX_tag34_A2,36,33,21,17,16,11,21,16,12,28
RNMB_Mix_BS_PIX_tag34_A3,22176,6699,1981,127,1876,49,1981,1876,4718,176
RNMB_Mix_BS_PIX_tag34_A4,2735,1276,674,45,665,34,674,665,602,79
RNMB_Mix_BS_PIX_tag34_A5,13094,6197,1863,67,1831,28,1863,1831,4334,95
RNMB_Mix_BS_PIX_tag34_A6,17,14,5,4,5,4,5,5,9,8
RNMB_Mix_BS_PIX_tag34_A7,30727,15610,4659,669,4415,379,4659,4415,10951,1048
RNMB_Mix_BS_PIX_tag34_A8,44,43,33,25,32,21,33,32,10,46
RNMB_Mix_BS_PIX_tag34_B1,662,342,80,31,67,19,80,67,262,50
RNMB_Mix_BS_PIX_tag34_B2,55,42,26,19,25,18,26,25,16,37
RNMB_Mix_BS_PIX_tag34_B3,1744,631,338,31,317,15,338,317,293,46
RNMB_Mix_BS_PIX_tag34_B4,5662,3018,1016,117,919,56,1016,919,2002,173
RNMB_Mix_BS_PIX_tag34_B5,524,360,167,17,167,15,167,167,193,32
RNMB_Mix_BS_PIX_tag34_B6,67,45,18,10,17,9,18,17,27,19
RNMB_Mix_BS_PIX_tag34_B7,23243,12120,3827,614,3590,342,3827,3590,8293,956
RNMB_Mix_BS_PIX_tag34_B8,6337,4024,1762,528,1597,345,1762,1597,2262,873
RNMB_Mix_BS_PIX_tag34_C1,445,179,106,10,102,6,106,102,73,16
RNMB_Mix_BS_PIX_tag34_C2,39,38,19,16,18,14,19,18,19,30
RNMB_Mix_BS_PIX_tag34_C3,112,70,27,15,26,14,27,26,43,29
RNMB_Mix_BS_PIX_tag34_C4,103,96,41,16,26,11,41,26,55,27
RNMB_Mix_BS_PIX_tag34_C5,255,165,53,19,53,19,53,53,112,38
RNMB_Mix_BS_PIX_tag34_C6,69,62,30,15,29,14,30,29,32,29
RNMB_Mix_BS_PIX_tag34_C7,33280,17047,5624,678,5356,381,5624,5356,11423,1059
RNMB_Mix_BS_PIX_tag34_C8,7165,4833,2058,585,1885,392,2058,1885,2775,977
RNMB_Mix_BS_PIX_tag34_D1,25,25,11,10,8,7,11,8,14,17
RNMB_Mix_BS_PIX_tag34_D2,17,15,8,8,8,8,8,8,7,16
RNMB_Mix_BS_PIX_tag34_D3,31,28,10,10,10,10,10,10,18,20
RNMB_Mix_BS_PIX_tag34_D4,68,44,25,8,24,6,25,24,19,14
RNMB_Mix_BS_PIX_tag34_D5,132,100,41,21,38,17,41,38,59,38
RNMB_Mix_BS_PIX_tag34_D6,111,91,43,23,37,18,43,37,48,41
RNMB_Mix_BS_PIX_tag34_D7,1155,801,402,142,373,101,402,373,399,243
RNMB_Mix_BS_PIX_tag34_D8,547,413,234,117,195,76,234,195,179,193
RNMB_Mix_BS_PIX_tag34_E1,19,18,6,5,6,5,6,6,12,10
RNMB_Mix_BS_PIX_tag34_E2,12,8,6,4,6,4,6,6,2,8
RNMB_Mix_BS_PIX_tag34_E3,62,54,27,16,23,11,27,23,27,27
RNMB_Mix_BS_PIX_tag34_E4,248,161,74,9,71,6,74,71,87,15
RNMB_Mix_BS_PIX_tag34_E5,7017,3310,1112,105,1015,47,1112,1015,2198,152
RNMB_Mix_BS_PIX_tag34_E6,27,17,11,5,11,5,11,11,6,10
RNMB_Mix_BS_PIX_tag34_E7,4569,2589,1101,193,1054,131,1101,1054,1488,324
RNMB_Mix_BS_PIX_tag34_E8,3212,2185,1039,353,946,252,1039,946,1146,605
RNMB_Mix_BS_PIX_tag34_F1,84,56,15,9,14,8,15,14,41,17
RNMB_Mix_BS_PIX_tag34_F2,20,18,13,12,12,11,13,12,5,23
RNMB_Mix_BS_PIX_tag34_F3,1377,811,373,30,350,14,373,350,438,44
RNMB_Mix_BS_PIX_tag34_F4,946,533,231,33,223,24,231,223,302,57
RNMB_Mix_BS_PIX_tag34_F5,4001,1871,438,53,392,29,438,392,1433,82
RNMB_Mix_BS_PIX_tag34_F6,1284,441,257,11,254,8,257,254,184,19
RNMB_Mix_BS_PIX_tag34_F7,5130,2812,1154,217,1100,154,1154,1100,1658,371
RNMB_Mix_BS_PIX_tag34_G1,46,29,16,8,16,8,16,16,13,16
RNMB_Mix_BS_PIX_tag34_G2,16,14,7,7,6,6,7,6,7,13
RNMB_Mix_BS_PIX_tag34_G3,234,93,43,10,9,4,43,9,50,14
RNMB_Mix_BS_PIX_tag34_G4,2558,1100,393,60,208,29,393,208,707,89
RNMB_Mix_BS_PIX_tag34_G5,85,61,46,20,40,15,46,40,15,35
RNMB_Mix_BS_PIX_tag34_G6,4710,1214,524,31,506,13,524,506,690,44
RNMB_Mix_BS_PIX_tag34_G7,11759,6945,2061,425,1857,227,2061,1857,4884,652
RNMB_Mix_BS_PIX_tag34_H1,113,61,15,7,12,5,15,12,46,12
RNMB_Mix_BS_PIX_tag34_H2,26,20,8,6,7,4,8,7,12,10
RNMB_Mix_BS_PIX_tag34_H3,308,221,71,18,65,11,71,65,150,29
RNMB_Mix_BS_PIX_tag34_H4,4111,1774,714,36,707,27,714,707,1060,63
RNMB_Mix_BS_PIX_tag34_H5,140,108,50,19,46,14,50,46,58,33
RNMB_Mix_BS_PIX_tag34_H6,7216,1888,613,31,600,16,613,600,1275,47
RNMB_Mix_BS_PIX_tag34_H7,2341,1593,601,189,498,100,601,498,992,289
RNMB_YHM_BS_P1_tag15_A10,973,469,180,23,168,13,180,168,289,36
RNMB_YHM_BS_P1_tag15_A11,1103,749,215,26,201,11,215,201,534,37
RNMB_YHM_BS_P1_tag15_A12,1099,831,224,45,188,20,224,188,607,65
RNMB_YHM_BS_P1_tag15_A1,341,285,54,12,45,9,54,45,231,21
RNMB_YHM_BS_P1_tag15_A2,80,70,29,17,25,13,29,25,41,30
RNMB_YHM_BS_P1_tag15_A3,13979,5517,1687,73,1609,33,1687,1609,3830,106
RNMB_YHM_BS_P1_tag15_A4,11443,4293,1455,64,1333,25,1455,1333,2838,89
RNMB_YHM_BS_P1_tag15_A5,11899,5961,1244,70,1208,37,1244,1208,4717,107
RNMB_YHM_BS_P1_tag15_A6,148,105,41,10,40,9,41,40,64,19
RNMB_YHM_BS_P1_tag15_A7,13653,6297,1562,93,1504,38,1562,1504,4735,131
RNMB_YHM_BS_P1_tag15_A8,14,11,4,4,3,3,4,3,7,7
RNMB_YHM_BS_P1_tag15_A9,696,410,95,34,75,19,95,75,315,53
RNMB_YHM_BS_P1_tag15_B10,44,39,18,14,18,14,18,18,21,28
RNMB_YHM_BS_P1_tag15_B11,42,38,21,13,17,10,21,17,17,23
RNMB_YHM_BS_P1_tag15_B12,316,228,84,26,71,14,84,71,144,40
RNMB_YHM_BS_P1_tag15_B1,1306,963,160,28,125,8,160,125,803,36
RNMB_YHM_BS_P1_tag15_B2,104,62,42,6,39,3,42,39,20,9
RNMB_YHM_BS_P1_tag15_B3,716,424,233,20,222,10,233,222,191,30
RNMB_YHM_BS_P1_tag15_B4,6079,2221,829,65,763,21,829,763,1392,86
RNMB_YHM_BS_P1_tag15_B5,246,156,36,22,28,15,36,28,120,37
RNMB_YHM_BS_P1_tag15_B6,15,15,6,6,6,6,6,6,9,12
RNMB_YHM_BS_P1_tag15_B7,11065,4365,1068,117,982,47,1068,982,3297,164
RNMB_YHM_BS_P1_tag15_B8,6983,3061,848,82,785,30,848,785,2213,112
RNMB_YHM_BS_P1_tag15_B9,97,69,30,14,28,10,30,28,39,24
RNMB_YHM_BS_P1_tag15_C10,180,123,36,16,32,12,36,32,87,28
RNMB_YHM_BS_P1_tag15_C11,1917,1183,355,40,328,19,355,328,828,59
RNMB_YHM_BS_P1_tag15_C12,3593,2309,606,62,572,22,606,572,1703,84
RNMB_YHM_BS_P1_tag15_C1,271,191,32,9,30,7,32,30,159,16
RNMB_YHM_BS_P1_tag15_C2,92,62,41,9,38,6,41,38,21,15
RNMB_YHM_BS_P1_tag15_C3,354,221,111,20,102,10,111,102,110,30
RNMB_YHM_BS_P1_tag15_C4,135,84,54,6,52,4,54,52,30,10
RNMB_YHM_BS_P1_tag15_C5,86,65,15,13,12,10,15,12,50,23
RNMB_YHM_BS_P1_tag15_C6,105,83,23,18,13,6,23,13,60,24
RNMB_YHM_BS_P1_tag15_C7,9573,4466,1483,122,1394,40,1483,1394,2983,162
RNMB_YHM_BS_P1_tag15_C9,8141,3393,1034,53,993,20,1034,993,2359,73
RNMB_YHM_BS_P1_tag15_D10,106,81,22,18,17,12,22,17,59,30
RNMB_YHM_BS_P1_tag15_D11,7889,4141,1024,58,977,18,1024,977,3117,76
RNMB_YHM_BS_P1_tag15_D12,4011,2469,637,65,613,28,637,613,1832,93
RNMB_YHM_BS_P1_tag15_D1,145,139,35,12,27,6,35,27,104,18
RNMB_YHM_BS_P1_tag15_D2,26,16,10,6,7,3,10,7,6,9
RNMB_YHM_BS_P1_tag15_D3,82,57,30,9,29,7,30,29,27,16
RNMB_YHM_BS_P1_tag15_D4,122,72,51,7,49,4,51,49,21,11
RNMB_YHM_BS_P1_tag15_D5,70,55,20,18,13,11,20,13,35,29
RNMB_YHM_BS_P1_tag15_D6,25,22,8,8,8,8,8,8,14,16
RNMB_YHM_BS_P1_tag15_D7,239,156,48,23,41,15,48,41,108,38
RNMB_YHM_BS_P1_tag15_D8,309,194,71,22,58,9,71,58,123,31
RNMB_YHM_BS_P1_tag15_D9,6183,3087,875,133,777,47,875,777,2212,180
RNMB_YHM_BS_P1_tag15_E10,2560,1323,398,53,375,28,398,375,925,81
RNMB_YHM_BS_P1_tag15_E11,1653,1073,309,55,247,19,309,247,764,74
RNMB_YHM_BS_P1_tag15_E12,1576,998,303,39,294,26,303,294,695,65
RNMB_YHM_BS_P1_tag15_E1,31,30,10,7,7,5,10,7,20,12
RNMB_YHM_BS_P1_tag15_E2,16,15,7,5,7,5,7,7,8,10
RNMB_YHM_BS_P1_tag15_E3,175,109,46,9,41,5,46,41,63,14
RNMB_YHM_BS_P1_tag15_E4,49,44,20,8,16,4,20,16,24,12
RNMB_YHM_BS_P1_tag15_E5,3235,1727,416,73,373,33,416,373,1311,106
RNMB_YHM_BS_P1_tag15_E6,215,141,49,21,43,15,49,43,92,36
RNMB_YHM_BS_P1_tag15_E7,463,283,76,27,59,16,76,59,207,43
RNMB_YHM_BS_P1_tag15_E8,4458,2000,628,61,591,23,628,591,1372,84
RNMB_YHM_BS_P1_tag15_F10,51,35,20,18,14,12,20,14,15,30
RNMB_YHM_BS_P1_tag15_F11,5445,2514,676,49,622,20,676,622,1838,69
RNMB_YHM_BS_P1_tag15_F12,353,278,101,24,95,15,101,95,177,39
RNMB_YHM_BS_P1_tag15_F1,112,75,44,9,43,8,44,43,31,17
RNMB_YHM_BS_P1_tag15_F2,23,17,8,4,8,4,8,8,9,8
RNMB_YHM_BS_P1_tag15_F3,438,385,95,22,69,6,95,69,290,28
RNMB_YHM_BS_P1_tag15_F4,625,371,118,33,105,17,118,105,253,50
RNMB_YHM_BS_P1_tag15_F5,407,253,97,30,83,15,97,83,156,45
RNMB_YHM_BS_P1_tag15_F6,200,123,18,13,15,9,18,15,105,22
RNMB_YHM_BS_P1_tag15_F7,4199,2264,668,132,561,32,668,561,1596,164
RNMB_YHM_BS_P1_tag15_F8,3274,1750,492,77,445,35,492,445,1258,112
RNMB_YHM_BS_P1_tag15_F9,653,376,110,57,69,21,110,69,266,78
RNMB_YHM_BS_P1_tag15_G10,377,282,78,22,68,11,78,68,204,33
RNMB_YHM_BS_P1_tag15_G11,8917,4586,1096,67,1038,22,1096,1038,3490,89
RNMB_YHM_BS_P1_tag15_G12,787,557,193,23,189,15,193,189,364,38
RNMB_YHM_BS_P1_tag15_G1,48,46,17,10,10,4,17,10,29,14
RNMB_YHM_BS_P1_tag15_G2,28,18,13,6,12,5,13,12,5,11
RNMB_YHM_BS_P1_tag15_G3,68,53,32,9,30,7,32,30,21,16
RNMB_YHM_BS_P1_tag15_G4,647,414,163,47,136,24,163,136,251,71
RNMB_YHM_BS_P1_tag15_G5,30,27,15,14,11,9,15,11,12,23
RNMB_YHM_BS_P1_tag15_G6,1399,680,214,65,169,23,214,169,466,88
RNMB_YHM_BS_P1_tag15_G7,4322,2202,566,60,538,32,566,538,1636,92
RNMB_YHM_BS_P1_tag15_G8,10171,4378,1204,70,1171,31,1204,1171,3174,101
RNMB_YHM_BS_P1_tag15_G9,8544,4009,1142,111,1065,46,1142,1065,2867,157
RNMB_YHM_BS_P1_tag15_H10,5651,3374,584,48,518,13,584,518,2790,61
RNMB_YHM_BS_P1_tag15_H11,3874,2103,609,55,562,19,609,562,1494,74
RNMB_YHM_BS_P1_tag15_H12,547,403,129,33,116,18,129,116,274,51
RNMB_YHM_BS_P1_tag15_H1,98,78,21,15,18,12,21,18,57,27
RNMB_YHM_BS_P1_tag15_H2,41,35,27,8,24,5,27,24,8,13
RNMB_YHM_BS_P1_tag15_H3,145,98,55,14,51,9,55,51,43,23
RNMB_YHM_BS_P1_tag15_H4,2933,1881,611,85,525,29,611,525,1270,114
RNMB_YHM_BS_P1_tag15_H5,87,78,28,21,19,11,28,19,50,32
RNMB_YHM_BS_P1_tag15_H6,5009,2605,674,54,640,23,674,640,1931,77
RNMB_YHM_BS_P1_tag15_H7,476,326,94,44,70,22,94,70,232,66
RNMB_YHM_BS_P1_tag15_H8,978,578,142,47,119,26,142,119,436,73
RNMB_YHM_BS_P1_tag15_H9,263,168,54,32,34,14,54,34,114,46
RNMB_YHM_BS_P2_tag38_A10,295,137,36,20,31,15,36,31,101,35
RNMB_YHM_BS_P2_tag38_A11,2212,971,421,53,390,24,421,390,550,77
RNMB_YHM_BS_P2_tag38_A1,146,124,52,19,48,15,52,48,72,34
RNMB_YHM_BS_P2_tag38_A2,51,43,21,10,20,9,21,20,22,19
RNMB_YHM_BS_P2_tag38_A3,20400,8096,1730,78,1683,25,1730,1683,6366,103
RNMB_YHM_BS_P2_tag38_A5,3217,1625,299,98,219,27,299,219,1326,125
RNMB_YHM_BS_P2_tag38_A4,9,9,6,4,6,4,6,6,3,8
RNMB_YHM_BS_P2_tag38_A6,129,84,34,16,25,11,34,25,50,27
RNMB_YHM_BS_P2_tag38_A7,10453,3363,839,109,554,28,839,554,2524,137
RNMB_YHM_BS_P2_tag38_A8,4,3,3,3,2,2,3,2,0,5
RNMB_YHM_BS_P2_tag38_A9,129,70,38,20,30,13,38,30,32,33
RNMB_YHM_BS_P2_tag38_B10,11,11,4,3,4,3,4,4,7,6
RNMB_YHM_BS_P2_tag38_B11,36,31,25,17,19,10,25,19,6,27
RNMB_YHM_BS_P2_tag38_B12,205,102,45,33,24,13,45,24,57,46
RNMB_YHM_BS_P2_tag38_B1,247,206,80,22,66,12,80,66,126,34
RNMB_YHM_BS_P2_tag38_B2,33,30,13,8,13,8,13,13,17,16
RNMB_YHM_BS_P2_tag38_B3,375,252,56,30,48,23,56,48,196,53
RNMB_YHM_BS_P2_tag38_B4,8784,1856,532,126,304,43,532,304,1324,169
RNMB_YHM_BS_P2_tag38_B5,95,65,30,18,24,12,30,24,35,30
RNMB_YHM_BS_P2_tag38_B6,25,19,13,12,8,7,13,8,6,19
RNMB_YHM_BS_P2_tag38_B8,2509,1237,474,46,454,22,474,454,763,68
RNMB_YHM_BS_P2_tag38_B9,36,21,8,7,7,6,8,7,13,13
RNMB_YHM_BS_P2_tag38_C10,264,160,62,29,46,14,62,46,98,43
RNMB_YHM_BS_P2_tag38_C11,3552,1240,422,78,364,31,422,364,818,109
RNMB_YHM_BS_P2_tag38_C12,3505,1750,415,86,370,45,415,370,1335,131
RNMB_YHM_BS_P2_tag38_C1,35,30,17,12,16,11,17,16,13,23
RNMB_YHM_BS_P2_tag38_C2,28,26,15,13,14,12,15,14,11,25
RNMB_YHM_BS_P2_tag38_C3,51,46,20,17,12,9,20,12,26,26
RNMB_YHM_BS_P2_tag38_C4,105,51,25,20,13,8,25,13,26,28
RNMB_YHM_BS_P2_tag38_C5,95,68,32,14,26,7,32,26,36,21
RNMB_YHM_BS_P2_tag38_C6,146,56,21,16,12,9,21,12,35,25
RNMB_YHM_BS_P2_tag38_C7,6001,1986,526,80,462,26,526,462,1460,106
RNMB_YHM_BS_P2_tag38_C8,3219,1291,472,47,454,26,472,454,819,73
RNMB_YHM_BS_P2_tag38_C9,4307,1871,453,61,419,33,453,419,1418,94
RNMB_YHM_BS_P2_tag38_D10,106,78,41,17,35,11,41,35,37,28
RNMB_YHM_BS_P2_tag38_D11,6732,2938,831,125,765,49,831,765,2107,174
RNMB_YHM_BS_P2_tag38_D12,2033,999,240,79,184,36,240,184,759,115
RNMB_YHM_BS_P2_tag38_D1,117,73,23,13,19,9,23,19,50,22
RNMB_YHM_BS_P2_tag38_D2,13,12,6,6,6,6,6,6,6,12
RNMB_YHM_BS_P2_tag38_D3,32,30,13,10,13,10,13,13,17,20
RNMB_YHM_BS_P2_tag38_D4,41,35,16,13,10,7,16,10,19,20
RNMB_YHM_BS_P2_tag38_D6,23,20,8,8,6,6,8,6,12,14
RNMB_YHM_BS_P2_tag38_D7,387,216,68,28,42,9,68,42,148,37
RNMB_YHM_BS_P2_tag38_D8,324,210,83,20,76,13,83,76,127,33
RNMB_YHM_BS_P2_tag38_D9,3558,1458,712,68,680,33,712,680,746,101
RNMB_YHM_BS_P2_tag38_E10,2480,808,354,38,273,18,354,273,454,56
RNMB_YHM_BS_P2_tag38_E11,2068,670,311,65,198,33,311,198,359,98
RNMB_YHM_BS_P2_tag38_E12,897,474,156,44,138,29,156,138,318,73
RNMB_YHM_BS_P2_tag38_E1,26,24,11,9,10,8,11,10,13,17
RNMB_YHM_BS_P2_tag38_E3,41,36,20,16,11,8,20,11,16,24
RNMB_YHM_BS_P2_tag38_E2,11,11,5,5,5,5,5,5,6,10
RNMB_YHM_BS_P2_tag38_E4,36,28,14,13,7,6,14,7,14,19
RNMB_YHM_BS_P2_tag38_E5,5334,2660,508,120,414,45,508,414,2152,165
RNMB_YHM_BS_P2_tag38_E6,167,61,19,13,12,10,19,12,42,23
RNMB_YHM_BS_P2_tag38_E7,630,362,106,45,76,16,106,76,256,61
RNMB_YHM_BS_P2_tag38_E8,2174,1108,317,62,288,30,317,288,791,92
RNMB_YHM_BS_P2_tag38_E9,2398,1284,244,64,206,30,244,206,1040,94
RNMB_YHM_BS_P2_tag38_F10,55,45,26,13,22,7,26,22,19,20
RNMB_YHM_BS_P2_tag38_F11,7921,2695,899,151,632,53,899,632,1796,204
RNMB_YHM_BS_P2_tag38_F12,695,332,143,38,101,16,143,101,189,54
RNMB_YHM_BS_P2_tag38_F1,36,32,20,14,17,11,20,17,12,25
RNMB_YHM_BS_P2_tag38_F2,31,31,14,10,14,10,14,14,17,20
RNMB_YHM_BS_P2_tag38_F3,543,240,87,61,33,15,87,33,153,76
RNMB_YHM_BS_P2_tag38_F5,1016,477,139,54,100,23,139,100,338,77
RNMB_YHM_BS_P2_tag38_F6,359,136,71,26,26,9,71,26,65,35
RNMB_YHM_BS_P2_tag38_F7,3726,1331,366,79,305,34,366,305,965,113
RNMB_YHM_BS_P2_tag38_F8,6121,2643,710,60,680,34,710,680,1933,94
RNMB_YHM_BS_P2_tag38_F9,1896,569,263,48,154,17,263,154,306,65
RNMB_YHM_BS_P2_tag38_G10,119,89,43,32,22,13,43,22,46,45
RNMB_YHM_BS_P2_tag38_G11,9841,3590,1099,133,939,45,1099,939,2491,178
RNMB_YHM_BS_P2_tag38_G12,461,272,79,39,64,22,79,64,193,61
RNMB_YHM_BS_P2_tag38_G1,24,22,8,7,5,3,8,5,14,10
RNMB_YHM_BS_P2_tag38_G2,42,36,16,9,15,7,16,15,20,16
RNMB_YHM_BS_P2_tag38_G3,70,60,24,16,14,7,24,14,36,23
RNMB_YHM_BS_P2_tag38_G4,1859,859,167,72,93,14,167,93,692,86
RNMB_YHM_BS_P2_tag38_G5,295,69,26,13,14,7,26,14,43,20
RNMB_YHM_BS_P2_tag38_G6,791,248,107,55,52,16,107,52,141,71
RNMB_YHM_BS_P2_tag38_G7,3093,1291,504,76,466,40,504,466,787,116
RNMB_YHM_BS_P2_tag38_G9,4323,1523,514,79,473,43,514,473,1009,122
RNMB_YHM_BS_P2_tag38_H11,5288,1792,505,43,481,19,505,481,1287,62
RNMB_YHM_BS_P2_tag38_H12,1460,682,150,44,133,21,150,133,532,65
RNMB_YHM_BS_P2_tag38_H1,33,29,17,11,16,10,17,16,12,21
RNMB_YHM_BS_P2_tag38_H2,38,32,12,6,12,6,12,12,20,12
RNMB_YHM_BS_P2_tag38_H3,353,227,55,22,47,13,55,47,172,35
RNMB_YHM_BS_P2_tag38_H4,3748,1645,415,103,302,20,415,302,1230,123
RNMB_YHM_BS_P2_tag38_H5,832,412,50,20,38,6,50,38,362,26
RNMB_YHM_BS_P2_tag38_H6,74,27,20,4,0,0,20,0,7,4
RNMB_YHM_BS_P2_tag38_H8,1194,566,254,42,236,27,254,236,312,69
RNMB_YHM_BS_P2_tag38_H9,297,175,64,30,52,17,64,52,111,47
RNMB_YHM_BS_P3_tag53_A10,218,170,28,13,21,6,28,21,142,19
RNMB_YHM_BS_P3_tag53_A11,3303,1957,491,83,421,21,491,421,1466,104
RNMB_YHM_BS_P3_tag53_A12,2436,1079,207,29,183,13,207,183,872,42
RNMB_YHM_BS_P3_tag53_A1,1460,1128,151,129,22,11,151,22,977,140
RNMB_YHM_BS_P3_tag53_A2,158,101,32,23,6,5,32,6,69,28
RNMB_YHM_BS_P3_tag53_A3,11952,4310,912,87,853,29,912,853,3398,116
RNMB_YHM_BS_P3_tag53_A4,2887,1798,318,96,222,23,318,222,1480,119
RNMB_YHM_BS_P3_tag53_A5,1032,797,80,66,21,8,80,21,717,74
RNMB_YHM_BS_P3_tag53_A6,8,8,2,2,2,2,2,2,6,4
RNMB_YHM_BS_P3_tag53_A7,8766,4790,1062,301,690,20,1062,690,3728,321
RNMB_YHM_BS_P3_tag53_A8,10,10,5,5,3,3,5,3,5,8
RNMB_YHM_BS_P3_tag53_A9,298,239,58,19,45,8,58,45,181,27
RNMB_YHM_BS_P3_tag53_B10,9,9,5,4,5,4,5,5,4,8
RNMB_YHM_BS_P3_tag53_B11,16,12,6,6,4,4,6,4,6,10
RNMB_YHM_BS_P3_tag53_B12,425,256,110,18,98,8,110,98,146,26
RNMB_YHM_BS_P3_tag53_B1,552,309,82,41,58,14,82,58,227,55
RNMB_YHM_BS_P3_tag53_B2,21,20,7,6,4,3,7,4,13,9
RNMB_YHM_BS_P3_tag53_B3,122,71,19,18,6,5,19,6,52,23
RNMB_YHM_BS_P3_tag53_B4,2552,1221,403,65,338,15,403,338,818,80
RNMB_YHM_BS_P3_tag53_B5,56,38,9,6,4,3,9,4,29,9
RNMB_YHM_BS_P3_tag53_B6,20,18,12,7,10,4,12,10,6,11
RNMB_YHM_BS_P3_tag53_B7,532,364,78,57,27,14,78,27,286,71
RNMB_YHM_BS_P3_tag53_B8,536,257,76,31,17,10,76,17,181,41
RNMB_YHM_BS_P3_tag53_B9,60,41,25,15,21,11,25,21,16,26
RNMB_YHM_BS_P3_tag53_C10,91,69,9,8,5,4,9,5,60,12
RNMB_YHM_BS_P3_tag53_C11,1451,814,317,40,289,11,317,289,497,51
RNMB_YHM_BS_P3_tag53_C12,7126,2438,703,49,675,22,703,675,1735,71
RNMB_YHM_BS_P3_tag53_C1,63,48,20,18,10,8,20,10,28,26
RNMB_YHM_BS_P3_tag53_C2,23,21,10,8,9,6,10,9,11,14
RNMB_YHM_BS_P3_tag53_C3,33,23,12,11,4,4,12,4,11,15
RNMB_YHM_BS_P3_tag53_C4,19,18,8,8,5,5,8,5,10,13
RNMB_YHM_BS_P3_tag53_C5,22,22,7,4,7,4,7,7,15,8
RNMB_YHM_BS_P3_tag53_C6,17,15,7,6,5,3,7,5,8,9
RNMB_YHM_BS_P3_tag53_C7,12863,5829,1517,46,1482,11,1517,1482,4312,57
RNMB_YHM_BS_P3_tag53_C8,139,112,26,19,10,8,26,10,86,27
RNMB_YHM_BS_P3_tag53_C9,3959,1924,514,16,509,8,514,509,1410,24
RNMB_YHM_BS_P3_tag53_D10,38,32,8,6,7,5,8,7,24,11
RNMB_YHM_BS_P3_tag53_D11,5218,2650,796,84,744,24,796,744,1854,108
RNMB_YHM_BS_P3_tag53_D12,7703,3190,817,52,788,24,817,788,2373,76
RNMB_YHM_BS_P3_tag53_D1,747,498,179,18,172,9,179,172,319,27
RNMB_YHM_BS_P3_tag53_D2,16,16,7,7,6,5,7,6,9,12
RNMB_YHM_BS_P3_tag53_D3,52,34,22,11,15,5,22,15,12,16
RNMB_YHM_BS_P3_tag53_D4,61,25,14,9,5,3,14,5,11,12
RNMB_YHM_BS_P3_tag53_D5,9,9,3,3,2,2,3,2,6,5
RNMB_YHM_BS_P3_tag53_D6,113,66,37,7,27,2,37,27,29,9
RNMB_YHM_BS_P3_tag53_D7,437,279,37,8,31,2,37,31,242,10
RNMB_YHM_BS_P3_tag53_D8,252,136,22,6,4,1,22,4,114,7
RNMB_YHM_BS_P3_tag53_D9,1927,966,302,24,290,12,302,290,664,36
RNMB_YHM_BS_P3_tag53_E10,750,463,171,58,120,11,171,120,292,69
RNMB_YHM_BS_P3_tag53_E11,944,550,148,33,124,9,148,124,402,42
RNMB_YHM_BS_P3_tag53_E12,363,257,89,30,69,14,89,69,168,44
RNMB_YHM_BS_P3_tag53_E1,21,15,9,7,5,3,9,5,6,10
RNMB_YHM_BS_P3_tag53_E2,5,5,1,1,0,0,1,0,4,1
RNMB_YHM_BS_P3_tag53_E3,19,15,6,6,2,2,6,2,9,8
RNMB_YHM_BS_P3_tag53_E4,44,19,11,6,3,2,11,3,8,8
RNMB_YHM_BS_P3_tag53_E5,2702,1505,198,40,162,13,198,162,1307,53
RNMB_YHM_BS_P3_tag53_E6,1196,674,256,23,229,5,256,229,418,28
RNMB_YHM_BS_P3_tag53_E7,697,360,44,11,36,4,44,36,316,15
RNMB_YHM_BS_P3_tag53_E8,1109,642,64,20,53,8,64,53,578,28
RNMB_YHM_BS_P3_tag53_E9,2608,1372,380,18,375,12,380,375,992,30
RNMB_YHM_BS_P3_tag53_F10,29,26,17,15,1,1,17,1,9,16
RNMB_YHM_BS_P3_tag53_F11,2602,1315,394,28,372,9,394,372,921,37
RNMB_YHM_BS_P3_tag53_F12,691,355,107,21,96,13,107,96,248,34
RNMB_YHM_BS_P3_tag53_F1,33,25,13,11,8,5,13,8,12,16
RNMB_YHM_BS_P3_tag53_F2,18,15,8,7,7,6,8,7,7,13
RNMB_YHM_BS_P3_tag53_F3,215,111,26,19,8,4,26,8,85,23
RNMB_YHM_BS_P3_tag53_F4,67,36,7,5,4,2,7,4,29,7
RNMB_YHM_BS_P3_tag53_F5,35,35,7,7,2,2,7,2,28,9
RNMB_YHM_BS_P3_tag53_F6,1561,898,341,22,308,7,341,308,557,29
RNMB_YHM_BS_P3_tag53_F7,469,278,36,28,12,5,36,12,242,33
RNMB_YHM_BS_P3_tag53_F8,1581,927,99,31,82,17,99,82,828,48
RNMB_YHM_BS_P3_tag53_F9,768,417,145,11,141,6,145,141,272,17
RNMB_YHM_BS_P3_tag53_G10,60,45,23,11,13,3,23,13,22,14
RNMB_YHM_BS_P3_tag53_G11,6317,3015,785,66,743,22,785,743,2230,88
RNMB_YHM_BS_P3_tag53_G12,1266,600,172,19,162,10,172,162,428,29
RNMB_YHM_BS_P3_tag53_G1,24,21,6,6,4,4,6,4,15,10
RNMB_YHM_BS_P3_tag53_G2,10,10,4,4,2,2,4,2,6,6
RNMB_YHM_BS_P3_tag53_G3,17,12,4,4,0,0,4,0,8,4
RNMB_YHM_BS_P3_tag53_G4,248,131,35,20,11,6,35,11,96,26
RNMB_YHM_BS_P3_tag53_G5,17,17,5,5,2,2,5,2,12,7
RNMB_YHM_BS_P3_tag53_G6,269,156,35,18,24,7,35,24,121,25
RNMB_YHM_BS_P3_tag53_G7,454,261,29,12,23,7,29,23,232,19
RNMB_YHM_BS_P3_tag53_G8,2469,1244,265,50,239,25,265,239,979,75
RNMB_YHM_BS_P3_tag53_G9,1133,571,195,12,191,7,195,191,376,19
RNMB_YHM_BS_P3_tag53_H10,3016,1506,386,42,357,12,386,357,1120,54
RNMB_YHM_BS_P3_tag53_H11,2544,1303,436,36,412,12,436,412,867,48
RNMB_YHM_BS_P3_tag53_H12,677,421,139,28,126,13,139,126,282,41
RNMB_YHM_BS_P3_tag53_H1,102,70,16,12,11,7,16,11,54,19
RNMB_YHM_BS_P3_tag53_H2,290,176,76,15,63,4,76,63,100,19
RNMB_YHM_BS_P3_tag53_H3,431,184,106,28,74,8,106,74,78,36
RNMB_YHM_BS_P3_tag53_H4,415,276,32,21,18,9,32,18,244,30
RNMB_YHM_BS_P3_tag53_H5,53,48,7,7,3,3,7,3,41,10
RNMB_YHM_BS_P3_tag53_H6,1593,992,239,59,195,20,239,195,753,79
RNMB_YHM_BS_P3_tag53_H7,114,77,22,8,11,2,22,11,55,10
RNMB_YHM_BS_P3_tag53_H8,1173,687,184,33,169,18,184,169,503,51
RNMB_YHM_BS_P3_tag53_H9,321,199,84,14,77,7,84,77,115,21
RNMB1_FXBSP1_tag08_A10,2101,975,419,36,409,27,419,409,556,63
RNMB1_FXBSP1_tag08_A11,5405,2611,938,67,923,49,938,923,1673,116
RNMB1_FXBSP1_tag08_A12,2415,1161,613,29,600,18,613,600,548,47
RNMB1_FXBSP1_tag08_A2,2753,1750,600,79,551,41,600,551,1150,120
RNMB1_FXBSP1_tag08_A4,2925,1657,555,79,522,39,555,522,1102,118
RNMB1_FXBSP1_tag08_A5,6495,3138,1247,73,1200,34,1247,1200,1891,107
RNMB1_FXBSP1_tag08_A6,2491,479,198,26,51,10,198,51,281,36
RNMB1_FXBSP1_tag08_A7,4495,2366,609,62,579,36,609,579,1757,98
RNMB1_FXBSP1_tag08_A9,12623,6710,1813,98,1761,50,1813,1761,4897,148
RNMB1_FXBSP1_tag08_B10,8235,4174,1327,94,1302,58,1327,1302,2847,152
RNMB1_FXBSP1_tag08_B12,4741,2589,736,66,716,38,736,716,1853,104
RNMB1_FXBSP1_tag08_B7,18819,8384,2281,110,2234,54,2281,2234,6103,164
RNMB1_FXBSP1_tag08_B8,6444,3521,1338,92,1293,54,1338,1293,2183,146
RNMB1_FXBSP1_tag08_C10,14616,7325,1825,85,1801,52,1825,1801,5500,137
RNMB1_FXBSP1_tag08_C11,7120,3535,1078,87,1052,48,1078,1052,2457,135
RNMB1_FXBSP1_tag08_C12,4529,2514,815,98,772,57,815,772,1699,155
RNMB1_FXBSP1_tag08_C1,1705,993,181,54,170,37,181,170,812,91
RNMB1_FXBSP1_tag08_C5,8659,4627,1350,78,1302,39,1350,1302,3277,117
RNMB1_FXBSP1_tag08_C8,7122,3920,1159,69,1099,44,1159,1099,2761,113
RNMB1_FXBSP1_tag08_C9,12696,6421,1893,101,1849,54,1893,1849,4528,155
RNMB1_FXBSP1_tag08_D10,7259,3310,1261,81,1245,51,1261,1245,2049,132
RNMB1_FXBSP1_tag08_D11,5475,2990,538,82,518,61,538,518,2452,143
RNMB1_FXBSP1_tag08_D12,3197,1805,509,62,490,39,509,490,1296,101
RNMB1_FXBSP1_tag08_D5,7766,3229,790,55,753,30,790,753,2439,85
RNMB1_FXBSP1_tag08_D6,9736,4952,1206,66,1172,36,1206,1172,3746,102
RNMB1_FXBSP1_tag08_D8,14039,7175,1987,128,1925,72,1987,1925,5188,200
RNMB1_FXBSP1_tag08_D9,11255,6134,1475,101,1431,56,1475,1431,4659,157
RNMB1_FXBSP1_tag08_E10,3315,1466,617,33,602,22,617,602,849,55
RNMB1_FXBSP1_tag08_E11,6143,3105,955,80,926,48,955,926,2150,128
RNMB1_FXBSP1_tag08_E12,2429,1228,521,39,511,26,521,511,707,65
RNMB1_FXBSP1_tag08_E5,8868,4701,1242,124,1155,53,1242,1155,3459,177
RNMB1_FXBSP1_tag08_E7,5647,3292,984,90,948,48,984,948,2308,138
RNMB1_FXBSP1_tag08_E8,14991,8997,1629,86,1162,35,1629,1162,7368,121
RNMB1_FXBSP1_tag08_E9,10512,5780,1374,104,1326,60,1374,1326,4406,164
RNMB1_FXBSP1_tag08_F10,2953,1381,521,47,509,30,521,509,860,77
RNMB1_FXBSP1_tag08_F11,5904,2540,834,58,814,36,834,814,1706,94
RNMB1_FXBSP1_tag08_F12,2711,1366,501,39,493,29,501,493,865,68
RNMB1_FXBSP1_tag08_F3,6587,3552,934,77,904,47,934,904,2618,124
RNMB1_FXBSP1_tag08_F6,5783,2948,921,58,891,30,921,891,2027,88
RNMB1_FXBSP1_tag08_F7,7492,4159,1308,65,1251,35,1308,1251,2851,100
RNMB1_FXBSP1_tag08_F8,12833,6413,1724,98,1684,42,1724,1684,4689,140
RNMB1_FXBSP1_tag08_F9,10127,5518,1614,90,1534,38,1614,1534,3904,128
RNMB1_FXBSP1_tag08_G10,6783,3071,1108,65,1089,40,1108,1089,1963,105
RNMB1_FXBSP1_tag08_G11,4147,2098,798,81,781,52,798,781,1300,133
RNMB1_FXBSP1_tag08_G12,2783,1486,598,56,576,36,598,576,888,92
RNMB1_FXBSP1_tag08_G1,7082,3947,1114,82,1094,42,1114,1094,2833,124
RNMB1_FXBSP1_tag08_G2,4586,2490,756,76,734,46,756,734,1734,122
RNMB1_FXBSP1_tag08_G3,5946,3334,1091,65,1013,37,1091,1013,2243,102
RNMB1_FXBSP1_tag08_G5,5512,3217,1033,82,968,41,1033,968,2184,123
RNMB1_FXBSP1_tag08_G6,2604,1646,591,91,541,49,591,541,1055,140
RNMB1_FXBSP1_tag08_G7,7144,3613,1050,76,1016,45,1050,1016,2563,121
RNMB1_FXBSP1_tag08_G8,10228,5341,1435,117,1360,60,1435,1360,3906,177
RNMB1_FXBSP1_tag08_G9,12859,6991,2270,114,2208,46,2270,2208,4721,160
RNMB1_FXBSP1_tag08_H10,976,511,156,30,155,28,156,155,355,58
RNMB1_FXBSP1_tag08_H11,918,470,204,39,195,29,204,195,266,68
RNMB1_FXBSP1_tag08_H12,2209,1270,397,44,368,28,397,368,873,72
RNMB1_FXBSP1_tag08_H1,3151,1884,539,50,528,31,539,528,1345,81
RNMB1_FXBSP1_tag08_H3,3379,1942,471,78,355,44,471,355,1471,122
RNMB1_FXBSP1_tag08_H4,2206,1236,584,45,568,29,584,568,652,74
RNMB1_FXBSP1_tag08_H7,4732,2511,828,71,801,39,828,801,1683,110
RNMB1_FXBSP1_tag08_H9,6451,3341,996,85,956,41,996,956,2345,126
RNMB1_FXBSP2_tag18_A10,10796,5204,868,82,821,40,868,821,4336,122
RNMB1_FXBSP2_tag18_A11,279,67,46,11,2,2,46,2,21,13
RNMB1_FXBSP2_tag18_A12,6037,3342,663,67,624,27,663,624,2679,94
RNMB1_FXBSP2_tag18_A2,6391,3462,860,56,844,35,860,844,2602,91
RNMB1_FXBSP2_tag18_A3,8415,3859,979,78,925,48,979,925,2880,126
RNMB1_FXBSP2_tag18_A5,10647,5606,1256,129,1121,44,1256,1121,4350,173
RNMB1_FXBSP2_tag18_A6,13451,7566,1717,117,1652,47,1717,1652,5849,164
RNMB1_FXBSP2_tag18_A7,3772,1878,488,62,465,34,488,465,1390,96
RNMB1_FXBSP2_tag18_A8,897,520,142,44,125,25,142,125,378,69
RNMB1_FXBSP2_tag18_B10,4005,1919,379,12,355,6,379,355,1540,18
RNMB1_FXBSP2_tag18_B11,4121,2199,538,97,445,34,538,445,1661,131
RNMB1_FXBSP2_tag18_B12,10956,5702,1465,49,1435,20,1465,1435,4237,69
RNMB1_FXBSP2_tag18_B1,13266,5248,1226,59,1211,39,1226,1211,4022,98
RNMB1_FXBSP2_tag18_B2,6624,3226,887,48,876,32,887,876,2339,80
RNMB1_FXBSP2_tag18_B3,4139,2307,541,62,520,41,541,520,1766,103
RNMB1_FXBSP2_tag18_B4,5144,3164,626,89,581,48,626,581,2538,137
RNMB1_FXBSP2_tag18_B5,5785,2474,989,82,860,43,989,860,1485,125
RNMB1_FXBSP2_tag18_B8,6704,3638,828,118,720,51,828,720,2810,169
RNMB1_FXBSP2_tag18_B9,8015,4418,1021,65,996,32,1021,996,3397,97
RNMB1_FXBSP2_tag18_C10,17413,8559,1861,71,1813,23,1861,1813,6698,94
RNMB1_FXBSP2_tag18_C11,20486,9737,2395,84,2332,28,2395,2332,7342,112
RNMB1_FXBSP2_tag18_C12,13734,7630,2192,99,2141,38,2192,2141,5438,137
RNMB1_FXBSP2_tag18_C1,19483,7459,1341,120,1235,45,1341,1235,6118,165
RNMB1_FXBSP2_tag18_C2,7059,3524,1230,72,1204,35,1230,1204,2294,107
RNMB1_FXBSP2_tag18_C3,10191,5098,1340,68,1318,44,1340,1318,3758,112
RNMB1_FXBSP2_tag18_C4,6634,3328,728,96,671,34,728,671,2600,130
RNMB1_FXBSP2_tag18_C5,2845,1477,448,67,423,33,448,423,1029,100
RNMB1_FXBSP2_tag18_C6,14482,7971,1949,135,1889,62,1949,1889,6022,197
RNMB1_FXBSP2_tag18_C7,11497,5857,1176,110,1137,65,1176,1137,4681,175
RNMB1_FXBSP2_tag18_C8,3282,1937,514,51,505,36,514,505,1423,87
RNMB1_FXBSP2_tag18_D11,15008,7643,1992,82,1970,38,1992,1970,5651,120
RNMB1_FXBSP2_tag18_D12,9348,4986,1201,70,1174,38,1201,1174,3785,108
RNMB1_FXBSP2_tag18_D1,12848,5104,1275,59,1262,37,1275,1262,3829,96
RNMB1_FXBSP2_tag18_D2,5276,2858,813,55,802,42,813,802,2045,97
RNMB1_FXBSP2_tag18_D3,10586,5260,1013,119,864,42,1013,864,4247,161
RNMB1_FXBSP2_tag18_D4,10002,4215,1250,58,1225,36,1250,1225,2965,94
RNMB1_FXBSP2_tag18_D5,4340,1821,698,71,665,43,698,665,1123,114
RNMB1_FXBSP2_tag18_D7,21732,10613,3018,223,2861,72,3018,2861,7595,295
RNMB1_FXBSP2_tag18_D6,3,3,2,2,2,2,2,2,1,4
RNMB1_FXBSP2_tag18_E10,12461,6586,1831,84,1758,20,1831,1758,4755,104
RNMB1_FXBSP2_tag18_E12,9253,4376,1380,44,1362,21,1380,1362,2996,65
RNMB1_FXBSP2_tag18_E1,8145,4175,1176,88,1146,50,1176,1146,2999,138
RNMB1_FXBSP2_tag18_E2,5729,3104,788,74,761,47,788,761,2316,121
RNMB1_FXBSP2_tag18_E3,6314,3542,667,114,581,50,667,581,2875,164
RNMB1_FXBSP2_tag18_E4,5208,2732,492,37,488,27,492,488,2240,64
RNMB1_FXBSP2_tag18_E6,9384,5302,1420,107,1305,52,1420,1305,3882,159
RNMB1_FXBSP2_tag18_E7,8150,4201,1083,103,1015,49,1083,1015,3118,152
RNMB1_FXBSP2_tag18_E8,8791,4319,1333,72,1313,34,1333,1313,2986,106
RNMB1_FXBSP2_tag18_E9,7371,3707,995,63,967,33,995,967,2712,96
RNMB1_FXBSP2_tag18_F10,14709,7597,1966,104,1892,36,1966,1892,5631,140
RNMB1_FXBSP2_tag18_F12,5700,3226,850,41,841,28,850,841,2376,69
RNMB1_FXBSP2_tag18_F2,5424,2915,728,74,690,35,728,690,2187,109
RNMB1_FXBSP2_tag18_F3,10230,4249,1305,42,1293,25,1305,1293,2944,67
RNMB1_FXBSP2_tag18_F4,5091,2883,410,79,394,48,410,394,2473,127
RNMB1_FXBSP2_tag18_F5,5983,3229,1060,98,1031,67,1060,1031,2169,165
RNMB1_FXBSP2_tag18_F6,8770,5016,1163,128,1063,66,1163,1063,3853,194
RNMB1_FXBSP2_tag18_F7,7467,3872,951,116,902,59,951,902,2921,175
RNMB1_FXBSP2_tag18_F8,7533,3902,1172,73,1152,40,1172,1152,2730,113
RNMB1_FXBSP2_tag18_F9,7509,3848,886,67,859,38,886,859,2962,105
RNMB1_FXBSP2_tag18_G10,27968,11391,2381,79,2340,35,2381,2340,9010,114
RNMB1_FXBSP2_tag18_G12,15832,8061,2267,153,2187,55,2267,2187,5794,208
RNMB1_FXBSP2_tag18_G1,12337,6171,1570,101,1537,52,1570,1537,4601,153
RNMB1_FXBSP2_tag18_G2,10423,5139,1002,86,939,33,1002,939,4137,119
RNMB1_FXBSP2_tag18_G3,7633,4654,725,97,683,49,725,683,3929,146
RNMB1_FXBSP2_tag18_G4,6943,3307,681,95,593,41,681,593,2626,136
RNMB1_FXBSP2_tag18_G5,13820,5289,1176,31,1161,11,1176,1161,4113,42
RNMB1_FXBSP2_tag18_G6,9885,5225,1516,125,1480,55,1516,1480,3709,180
RNMB1_FXBSP2_tag18_G7,8852,4383,1114,105,1056,56,1114,1056,3269,161
RNMB1_FXBSP2_tag18_G8,7684,3759,1101,56,1086,27,1101,1086,2658,83
RNMB1_FXBSP2_tag18_G9,9468,3779,826,72,502,30,826,502,2953,102
RNMB1_FXBSP2_tag18_H12,7853,4440,942,77,922,43,942,922,3498,120
RNMB1_FXBSP2_tag18_H1,6204,3369,939,70,917,37,939,917,2430,107
RNMB1_FXBSP2_tag18_H2,9173,5790,722,64,670,27,722,670,5068,91
RNMB1_FXBSP2_tag18_H3,10460,4887,1069,69,1041,37,1069,1041,3818,106
RNMB1_FXBSP2_tag18_H5,14107,7884,1913,95,1849,29,1913,1849,5971,124
RNMB1_FXBSP2_tag18_H6,14067,7445,1824,132,1722,46,1824,1722,5621,178
RNMB1_FXBSP2_tag18_H9,3562,1758,407,66,355,24,407,355,1351,90
RNMB1_FXBSP3_tag42_A12,7702,4755,714,157,626,30,714,626,4041,187
RNMB1_FXBSP3_tag42_A2,1739,1013,331,33,325,22,331,325,682,55
RNMB1_FXBSP3_tag42_A6,3327,2002,525,58,465,27,525,465,1477,85
RNMB1_FXBSP3_tag42_A8,4571,2421,801,48,788,28,801,788,1620,76
RNMB1_FXBSP3_tag42_A9,5010,2677,786,48,774,29,786,774,1891,77
RNMB1_FXBSP3_tag42_B1,2063,1118,360,34,352,20,360,352,758,54
RNMB1_FXBSP3_tag42_B5,4886,2445,906,38,892,21,906,892,1539,59
RNMB1_FXBSP3_tag42_B6,3797,1996,573,26,559,15,573,559,1423,41
RNMB1_FXBSP3_tag42_B7,5681,2733,774,41,763,30,774,763,1959,71
RNMB1_FXBSP3_tag42_C10,10798,5274,1213,132,1159,58,1213,1159,4061,190
RNMB1_FXBSP3_tag42_C11,9894,5796,1125,243,1014,86,1125,1014,4671,329
RNMB1_FXBSP3_tag42_C2,1123,642,232,28,229,19,232,229,410,47
RNMB1_FXBSP3_tag42_C7,4964,2299,680,38,670,24,680,670,1619,62
RNMB1_FXBSP3_tag42_D3,4947,2512,1037,39,1031,26,1037,1031,1475,65
RNMB1_FXBSP3_tag42_D5,7215,3747,1068,33,1062,25,1068,1062,2679,58
RNMB1_FXBSP3_tag42_E10,4751,3328,522,116,478,54,522,478,2806,170
RNMB1_FXBSP3_tag42_E11,6684,3926,794,142,749,76,794,749,3132,218
RNMB1_FXBSP3_tag42_E12,1997,1145,248,42,236,28,248,236,897,70
RNMB1_FXBSP3_tag42_E2,2744,1526,512,45,494,28,512,494,1014,73
RNMB1_FXBSP3_tag42_E4,1681,938,367,30,356,19,367,356,571,49
RNMB1_FXBSP3_tag42_E6,4114,2105,619,58,601,31,619,601,1486,89
RNMB1_FXBSP3_tag42_E9,5331,2814,711,130,662,63,711,662,2103,193
RNMB1_FXBSP3_tag42_F11,6520,3498,851,129,820,68,851,820,2647,197
RNMB1_FXBSP3_tag42_F12,3415,1949,258,52,237,29,258,237,1691,81
RNMB1_FXBSP3_tag42_F5,2315,1258,468,41,450,25,468,450,790,66
RNMB1_FXBSP3_tag42_G5,6290,2881,905,35,896,24,905,896,1976,59
RNMB1_FXBSP3_tag42_G6,4778,2621,772,48,756,27,772,756,1849,75
RNMB1_FXBSP3_tag42_H12,3913,2275,299,57,273,29,299,273,1976,86
RNMB1_FXBSP3_tag42_H2,2370,1376,465,37,452,19,465,452,911,56
RNMB1_FXBSP3_tag42_H3,2250,1289,344,32,336,22,344,336,945,54
RNMB1_FXBSP3_tag42_H6,1752,957,255,23,250,15,255,250,702,38
RNMB1_FXBSP3_tag42_H7,5111,2578,767,32,759,22,767,759,1811,54
RNMB1_FXBSP3_tag42_H8,4970,2512,846,49,835,29,846,835,1666,78
RNMB2_FXBSP4_tag07_A10,1097,591,227,42,207,21,227,207,364,63
RNMB2_FXBSP4_tag07_A11,5723,3834,656,34,579,9,656,579,3178,43
RNMB2_FXBSP4_tag07_A12,719,476,151,25,143,17,151,143,325,42
RNMB2_FXBSP4_tag07_B10,4173,2283,757,59,729,32,757,729,1526,91
RNMB2_FXBSP4_tag07_B11,299,208,70,12,69,10,70,69,138,22
RNMB2_FXBSP4_tag07_B12,315,229,61,19,57,14,61,57,168,33
RNMB2_FXBSP4_tag07_C10,6,6,5,5,2,2,5,2,1,7
RNMB2_FXBSP4_tag07_C11,1233,777,279,51,265,30,279,265,498,81
RNMB2_FXBSP4_tag07_C12,3090,1830,249,34,244,23,249,244,1581,57
RNMB2_FXBSP4_tag07_C9,4206,2794,498,48,403,11,498,403,2296,59
RNMB2_FXBSP4_tag07_D10,2275,1229,189,34,179,22,189,179,1040,56
RNMB2_FXBSP4_tag07_D11,2839,1423,442,42,424,23,442,424,981,65
RNMB2_FXBSP4_tag07_D12,2331,1415,167,29,160,20,167,160,1248,49
RNMB2_FXBSP4_tag07_D9,3331,1827,425,38,403,16,425,403,1402,54
RNMB2_FXBSP4_tag07_E10,2933,1641,369,38,352,25,369,352,1272,63
RNMB2_FXBSP4_tag07_E11,3425,1752,339,32,330,23,339,330,1413,55
RNMB2_FXBSP4_tag07_E12,2871,1633,496,44,488,31,496,488,1137,75
RNMB2_FXBSP4_tag07_E9,2465,1366,301,45,293,27,301,293,1065,72
RNMB2_FXBSP4_tag07_F10,4206,2428,393,53,375,26,393,375,2035,79
RNMB2_FXBSP4_tag07_F11,833,538,141,35,130,20,141,130,397,55
RNMB2_FXBSP4_tag07_F12,2354,1467,323,43,316,25,323,316,1144,68
RNMB2_FXBSP4_tag07_F9,1912,1137,427,47,415,29,427,415,710,76
RNMB2_FXBSP4_tag07_G10,920,710,163,23,129,9,163,129,547,32
RNMB2_FXBSP4_tag07_G11,805,529,177,33,168,23,177,168,352,56
RNMB2_FXBSP4_tag07_G12,4026,2290,457,105,424,41,457,424,1833,146
RNMB2_FXBSP4_tag07_G9,1588,847,397,39,385,27,397,385,450,66
RNMB2_FXBSP4_tag07_H10,74,55,16,9,14,7,16,14,39,16
RNMB2_FXBSP4_tag07_H11,400,284,70,23,68,17,70,68,214,40
RNMB2_FXBSP4_tag07_H12,6128,4038,570,93,532,44,570,532,3468,137
RNBC1_QLMSP4_tag11_A10,2040,1213,127,14,119,6,127,119,1086,20
RNBC1_QLMSP4_tag11_A11,4434,1457,458,32,429,5,458,429,999,37
RNBC1_QLMSP4_tag11_A12,3439,1280,311,9,310,5,311,310,969,14
RNBC1_QLMSP4_tag11_A6,4188,1387,342,7,336,1,342,336,1045,8
RNBC1_QLMSP4_tag11_A7,170,56,3,1,3,1,3,3,53,2
RNBC1_QLMSP4_tag11_A8,1041,439,171,3,169,1,171,169,268,4
RNBC1_QLMSP4_tag11_A9,2280,1060,164,9,155,4,164,155,896,13
RNBC1_QLMSP4_tag11_B10,4923,1686,352,6,349,3,352,349,1334,9
RNBC1_QLMSP4_tag11_B11,2535,1293,297,12,293,9,297,293,996,21
RNBC1_QLMSP4_tag11_B2,4399,1280,375,3,374,2,375,374,905,5
RNBC1_QLMSP4_tag11_B3,3527,1542,516,14,509,5,516,509,1026,19
RNBC1_QLMSP4_tag11_B4,1445,739,66,7,57,2,66,57,673,9
RNBC1_QLMSP4_tag11_B5,521,287,29,10,26,6,29,26,258,16
RNBC1_QLMSP4_tag11_B7,959,519,101,8,98,4,101,98,418,12
RNBC1_QLMSP4_tag11_B8,283,170,24,3,24,3,24,24,146,6
RNBC1_QLMSP4_tag11_B9,55,37,14,10,6,2,14,6,23,12
RNBC1_QLMSP4_tag11_C10,8135,2383,476,1,476,1,476,476,1907,2
RNBC1_QLMSP4_tag11_C11,32,22,10,7,9,6,10,9,12,13
RNBC1_QLMSP4_tag11_C12,59,43,16,4,14,1,16,14,27,5
RNBC1_QLMSP4_tag11_C2,1032,549,63,7,58,4,63,58,486,11
RNBC1_QLMSP4_tag11_C3,482,275,70,4,70,3,70,70,205,7
RNBC1_QLMSP4_tag11_C4,1244,590,146,5,144,2,146,144,444,7
RNBC1_QLMSP4_tag11_C5,45,36,2,2,2,2,2,2,34,4
RNBC1_QLMSP4_tag11_C6,2053,981,146,6,145,5,146,145,835,11
RNBC1_QLMSP4_tag11_C7,374,203,58,5,57,4,58,57,145,9
RNBC1_QLMSP4_tag11_C9,984,511,64,6,59,2,64,59,447,8
RNBC1_QLMSP4_tag11_D10,53,46,10,7,6,3,10,6,36,10
RNBC1_QLMSP4_tag11_D11,1331,599,113,4,113,4,113,113,486,8
RNBC1_QLMSP4_tag11_D1,1003,405,65,4,62,2,65,62,340,6
RNBC1_QLMSP4_tag11_D2,45,34,9,3,9,3,9,9,25,6
RNBC1_QLMSP4_tag11_D3,3057,1060,218,3,217,2,218,217,842,5
RNBC1_QLMSP4_tag11_D4,2714,934,204,1,204,1,204,204,730,2
RNBC1_QLMSP4_tag11_D5,171,127,19,4,17,3,19,17,108,7
RNBC1_QLMSP4_tag11_D7,7415,2189,505,1,505,1,505,505,1684,2
RNBC1_QLMSP4_tag11_D9,61,51,3,2,2,1,3,2,48,3
RNBC1_QLMSP4_tag11_E10,17,16,3,3,2,2,3,2,13,5
RNBC1_QLMSP4_tag11_E1,370,233,68,1,68,1,68,68,165,2
RNBC1_QLMSP4_tag11_E2,1841,709,134,4,132,2,134,132,575,6
RNBC1_QLMSP4_tag11_E3,3740,1151,254,2,253,1,254,253,897,3
RNBC1_QLMSP4_tag11_E5,3323,1342,263,15,253,5,263,253,1079,20
RNBC1_QLMSP4_tag11_E6,4049,1218,298,1,298,1,298,298,920,2
RNBC1_QLMSP4_tag11_E7,1224,561,112,13,106,7,112,106,449,20
RNBC1_QLMSP4_tag11_E8,154,101,12,5,10,3,12,10,89,8
RNBC1_QLMSP4_tag11_F10,94,57,11,7,6,2,11,6,46,9
RNBC1_QLMSP4_tag11_F11,3368,1174,245,1,245,1,245,245,929,2
RNBC1_QLMSP4_tag11_F12,1748,744,133,4,131,2,133,131,611,6
RNBC1_QLMSP4_tag11_F1,1,1,0,0,0,0,0,0,1,0
RNBC1_QLMSP4_tag11_F2,42,35,11,10,6,5,11,6,24,15
RNBC1_QLMSP4_tag11_F3,13,10,1,1,1,1,1,1,9,2
RNBC1_QLMSP4_tag11_F4,1005,451,162,3,161,2,162,161,289,5
RNBC1_QLMSP4_tag11_F6,1611,741,114,2,114,1,114,114,627,3
RNBC1_QLMSP4_tag11_F7,101,73,5,2,5,2,5,5,68,4
RNBC1_QLMSP4_tag11_F8,5304,1613,358,3,358,3,358,358,1255,6
RNBC1_QLMSP4_tag11_G10,8409,3294,594,35,550,6,594,550,2700,41
RNBC1_QLMSP4_tag11_G12,278,175,33,15,31,13,33,31,142,28
RNBC1_QLMSP4_tag11_G1,497,271,23,7,21,5,23,21,248,12
RNBC1_QLMSP4_tag11_G3,191,108,10,6,8,4,10,8,98,10
RNBC1_QLMSP4_tag11_G4,22,13,4,4,3,3,4,3,9,7
RNBC1_QLMSP4_tag11_G5,6610,2580,647,12,633,4,647,633,1933,16
RNBC1_QLMSP4_tag11_G7,1223,783,71,24,56,6,71,56,712,30
RNBC1_QLMSP4_tag11_G8,2920,1022,209,6,207,4,209,207,813,10
RNBC1_QLMSP4_tag11_G9,4783,2038,343,28,326,6,343,326,1695,34
RNBC1_QLMSP4_tag11_H11,10,2,1,1,0,0,1,0,1,1
RNBC1_QLMSP4_tag11_H1,300,119,12,4,9,1,12,9,107,5
RNBC1_QLMSP4_tag11_H2,428,261,37,6,34,2,37,34,224,8
RNBC1_QLMSP4_tag11_H3,732,336,41,2,41,1,41,41,295,3
RNBC1_QLMSP4_tag11_H5,712,319,36,3,36,3,36,36,283,6
RNBC1_QLMSP4_tag11_H6,170,73,1,1,1,1,1,1,72,2
RNBC1_QLMSP4_tag11_H7,868,429,39,7,29,3,39,29,390,10
RNBC1_QLMSP4_tag11_H9,951,397,50,13,23,2,50,23,347,15
RNBC1_QLMSP5_tag03_A11,639,266,39,5,35,2,39,35,227,7
RNBC1_QLMSP5_tag03_A12,1131,463,59,3,57,1,59,57,404,4
RNBC1_QLMSP5_tag03_A1,294,131,49,6,44,2,49,44,82,8
RNBC1_QLMSP5_tag03_A3,37,27,4,4,0,0,4,0,23,4
RNBC1_QLMSP5_tag03_A5,6,6,1,1,1,1,1,1,5,2
RNBC1_QLMSP5_tag03_A6,1911,597,120,3,120,3,120,120,477,6
RNBC1_QLMSP5_tag03_A7,229,75,17,8,7,2,17,7,58,10
RNBC1_QLMSP5_tag03_A9,49,21,5,3,3,1,5,3,16,4
RNBC1_QLMSP5_tag03_B10,739,378,77,3,75,1,77,75,301,4
RNBC1_QLMSP5_tag03_B11,763,296,28,1,28,1,28,28,268,2
RNBC1_QLMSP5_tag03_B12,392,158,23,12,10,1,23,10,135,13
RNBC1_QLMSP5_tag03_B1,58,38,8,5,7,4,8,7,30,9
RNBC1_QLMSP5_tag03_B2,1,1,0,0,0,0,0,0,1,0
RNBC1_QLMSP5_tag03_B3,700,218,47,12,16,4,47,16,171,16
RNBC1_QLMSP5_tag03_B4,638,295,37,4,34,1,37,34,258,5
RNBC1_QLMSP5_tag03_B5,361,193,13,2,13,2,13,13,180,4
RNBC1_QLMSP5_tag03_B6,397,179,16,6,11,3,16,11,163,9
RNBC1_QLMSP5_tag03_B7,1411,459,182,4,182,1,182,182,277,5
RNBC1_QLMSP5_tag03_B8,231,138,12,5,10,3,12,10,126,8
RNBC1_QLMSP5_tag03_B9,610,308,36,2,35,1,36,35,272,3
RNBC1_QLMSP5_tag03_C11,159,102,20,9,19,5,20,19,82,14
RNBC1_QLMSP5_tag03_C12,511,162,70,12,64,1,70,64,92,13
RNBC1_QLMSP5_tag03_C1,757,292,43,5,40,2,43,40,249,7
RNBC1_QLMSP5_tag03_C2,972,404,197,8,190,1,197,190,207,9
RNBC1_QLMSP5_tag03_C3,667,307,91,8,86,2,91,86,216,10
RNBC1_QLMSP5_tag03_C5,591,249,119,2,119,2,119,119,130,4
RNBC1_QLMSP5_tag03_C6,100,60,2,2,2,2,2,2,58,4
RNBC1_QLMSP5_tag03_C7,217,124,13,6,11,3,13,11,111,9
RNBC1_QLMSP5_tag03_C8,19,10,6,3,6,3,6,6,4,6
RNBC1_QLMSP5_tag03_C9,957,431,65,7,60,3,65,60,366,10
RNBC1_QLMSP5_tag03_D10,19,9,4,4,1,1,4,1,5,5
RNBC1_QLMSP5_tag03_D11,834,416,49,1,49,1,49,49,367,2
RNBC1_QLMSP5_tag03_D12,449,304,37,14,10,4,37,10,267,18
RNBC1_QLMSP5_tag03_D1,481,217,26,4,24,2,26,24,191,6
RNBC1_QLMSP5_tag03_D2,556,236,34,7,27,1,34,27,202,8
RNBC1_QLMSP5_tag03_D3,249,108,7,3,5,1,7,5,101,4
RNBC1_QLMSP5_tag03_D4,521,225,31,6,26,1,31,26,194,7
RNBC1_QLMSP5_tag03_D5,1428,755,103,12,86,2,103,86,652,14
RNBC1_QLMSP5_tag03_D6,1133,467,75,5,71,1,75,71,392,6
RNBC1_QLMSP5_tag03_D8,311,153,15,5,12,2,15,12,138,7
RNBC1_QLMSP5_tag03_E10,368,183,19,10,10,1,19,10,164,11
RNBC1_QLMSP5_tag03_E11,615,341,61,11,52,5,61,52,280,16
RNBC1_QLMSP5_tag03_E12,389,244,15,6,12,3,15,12,229,9
RNBC1_QLMSP5_tag03_E1,13,11,3,3,1,1,3,1,8,4
RNBC1_QLMSP5_tag03_E2,19,13,6,5,1,1,6,1,7,6
RNBC1_QLMSP5_tag03_E3,197,124,29,16,15,4,29,15,95,20
RNBC1_QLMSP5_tag03_E4,91,46,13,1,13,1,13,13,33,2
RNBC1_QLMSP5_tag03_E5,603,247,44,3,43,2,44,43,203,5
RNBC1_QLMSP5_tag03_E6,405,218,25,3,24,2,25,24,193,5
RNBC1_QLMSP5_tag03_E7,41,30,3,2,2,1,3,2,27,3
RNBC1_QLMSP5_tag03_E8,13,9,2,2,0,0,2,0,7,2
RNBC1_QLMSP5_tag03_E9,529,227,31,2,30,1,31,30,196,3
RNBC1_QLMSP5_tag03_F10,1761,718,336,7,333,4,336,333,382,11
RNBC1_QLMSP5_tag03_F11,562,275,148,4,148,4,148,148,127,8
RNBC1_QLMSP5_tag03_F12,859,360,54,4,51,1,54,51,306,5
RNBC1_QLMSP5_tag03_F2,12,6,2,2,0,0,2,0,4,2
RNBC1_QLMSP5_tag03_F3,160,82,27,5,22,1,27,22,55,6
RNBC1_QLMSP5_tag03_F1,3,3,0,0,0,0,0,0,3,0
RNBC1_QLMSP5_tag03_F4,3,3,0,0,0,0,0,0,3,0
RNBC1_QLMSP5_tag03_F5,360,215,18,9,5,1,18,5,197,10
RNBC1_QLMSP5_tag03_F6,916,394,56,5,55,2,56,55,338,7
RNBC1_QLMSP5_tag03_F7,158,74,6,5,4,3,6,4,68,8
RNBC1_QLMSP5_tag03_F8,488,252,26,7,20,2,26,20,226,9
RNBC1_QLMSP5_tag03_F9,616,357,48,2,47,1,48,47,309,3
RNBC1_QLMSP5_tag03_G10,2395,918,187,3,186,1,187,186,731,4
RNBC1_QLMSP5_tag03_G11,1659,657,148,4,146,2,148,146,509,6
RNBC1_QLMSP5_tag03_G12,869,357,37,17,21,3,37,21,320,20
RNBC1_QLMSP5_tag03_G1,771,398,85,7,84,6,85,84,313,13
RNBC1_QLMSP5_tag03_G2,818,404,58,12,52,3,58,52,346,15
RNBC1_QLMSP5_tag03_G3,201,143,21,9,17,3,21,17,122,12
RNBC1_QLMSP5_tag03_G4,1115,407,65,3,63,1,65,63,342,4
RNBC1_QLMSP5_tag03_G5,729,322,58,3,56,1,58,56,264,4
RNBC1_QLMSP5_tag03_G6,146,85,23,3,23,3,23,23,62,6
RNBC1_QLMSP5_tag03_G7,979,408,52,1,52,1,52,52,356,2
RNBC1_QLMSP5_tag03_G8,1018,509,57,8,52,2,57,52,452,10
RNBC1_QLMSP5_tag03_G9,835,426,66,9,63,3,66,63,360,12
RNBC1_QLMSP5_tag03_H10,169,106,12,5,9,2,12,9,94,7
RNBC1_QLMSP5_tag03_H11,236,123,31,12,21,2,31,21,92,14
RNBC1_QLMSP5_tag03_H12,1816,662,128,7,126,3,128,126,534,10
RNBC1_QLMSP5_tag03_H1,895,332,51,1,51,1,51,51,281,2
RNBC1_QLMSP5_tag03_H2,537,233,127,4,125,2,127,125,106,6
RNBC1_QLMSP5_tag03_H3,203,111,27,7,21,2,27,21,84,9
RNBC1_QLMSP5_tag03_H5,116,53,12,11,4,3,12,4,41,14
RNBC1_QLMSP5_tag03_H4,13,8,2,1,2,1,2,2,6,2
RNBC1_QLMSP5_tag03_H6,6,5,1,1,0,0,1,0,4,1
RNBC1_QLMSP5_tag03_H7,989,657,56,10,53,4,56,53,601,14
RNBC1_QLMSP5_tag03_H8,175,108,22,9,14,3,22,14,86,12
RNBC1_QLMSP5_tag03_H9,22,14,4,4,0,0,4,0,10,4
RNBC1_QLMSP6_tag05_A10,78,41,4,2,3,1,4,3,37,3
RNBC1_QLMSP6_tag05_A4,336,133,11,1,11,1,11,11,122,2
RNBC1_QLMSP6_tag05_A6,999,332,41,2,40,1,41,40,291,3
RNBC1_QLMSP6_tag05_A8,241,133,54,36,14,6,54,14,79,42
RNBC1_QLMSP6_tag05_B12,251,152,15,8,12,4,15,12,137,12
RNBC1_QLMSP6_tag05_B2,620,264,20,2,20,1,20,20,244,3
RNBC1_QLMSP6_tag05_B3,442,232,22,3,21,2,22,21,210,5
RNBC1_QLMSP6_tag05_B4,246,106,44,5,43,2,44,43,62,7
RNBC1_QLMSP6_tag05_B8,425,194,26,6,24,2,26,24,168,8
RNBC1_QLMSP6_tag05_C10,1080,417,72,10,67,3,72,67,345,13
RNBC1_QLMSP6_tag05_C11,328,119,16,5,10,1,16,10,103,6
RNBC1_QLMSP6_tag05_C2,309,121,10,1,10,1,10,10,111,2
RNBC1_QLMSP6_tag05_C4,311,134,55,4,55,2,55,55,79,6
RNBC1_QLMSP6_tag05_C6,1421,610,168,8,159,2,168,159,442,10
RNBC1_QLMSP6_tag05_C7,1006,388,86,3,86,3,86,86,302,6
RNBC1_QLMSP6_tag05_C9,144,73,25,6,22,3,25,22,48,9
RNBC1_QLMSP6_tag05_D10,212,108,13,6,11,2,13,11,95,8
RNBC1_QLMSP6_tag05_D2,467,219,40,9,35,4,40,35,179,13
RNBC1_QLMSP6_tag05_D5,1832,565,216,8,207,1,216,207,349,9
RNBC1_QLMSP6_tag05_D6,1765,725,128,6,126,3,128,126,597,9
RNBC1_QLMSP6_tag05_D9,47,24,4,4,3,3,4,3,20,7
RNBC1_QLMSP6_tag05_E10,2670,867,264,1,264,1,264,264,603,2
RNBC1_QLMSP6_tag05_E11,2328,762,157,4,152,1,157,152,605,5
RNBC1_QLMSP6_tag05_E12,1892,757,141,9,134,3,141,134,616,12
RNBC1_QLMSP6_tag05_E1,371,172,64,12,59,6,64,59,108,18
RNBC1_QLMSP6_tag05_E3,427,184,49,3,48,2,49,48,135,5
RNBC1_QLMSP6_tag05_E4,45,26,8,5,4,2,8,4,18,7
RNBC1_QLMSP6_tag05_E6,1784,634,236,1,236,1,236,236,398,2
RNBC1_QLMSP6_tag05_E9,1309,531,104,6,102,3,104,102,427,9
RNBC1_QLMSP6_tag05_F11,1523,647,92,12,79,1,92,79,555,13
RNBC1_QLMSP6_tag05_F12,2274,838,192,1,192,1,192,192,646,2
RNBC1_QLMSP6_tag05_F4,643,262,105,2,105,2,105,105,157,4
RNBC1_QLMSP6_tag05_F7,3665,2177,267,35,245,4,267,245,1910,39
RNBC1_QLMSP6_tag05_G10,5368,2075,363,10,346,2,363,346,1712,12
RNBC1_QLMSP6_tag05_G11,2484,1292,220,27,190,6,220,190,1072,33
RNBC1_QLMSP6_tag05_G1,927,337,44,3,41,1,44,41,293,4
RNBC1_QLMSP6_tag05_G7,3211,1595,221,16,209,4,221,209,1374,20
RNBC1_QLMSP6_tag05_G8,3425,1202,358,3,358,3,358,358,844,6
RNBC1_QLMSP6_tag05_G9,1228,593,82,9,77,5,82,77,511,14
RNBC1_QLMSP6_tag05_H10,691,229,37,6,31,2,37,31,192,8
RNBC1_QLMSP6_tag05_H11,1786,1019,169,28,146,3,169,146,850,31
RNBC1_QLMSP6_tag05_H1,170,108,36,3,35,2,36,35,72,5
RNBC1_QLMSP6_tag05_H2,965,461,77,7,75,4,77,75,384,11
RNBC1_QLMSP6_tag05_H3,367,155,48,3,46,1,48,46,107,4
RNBC1_QLMSP6_tag05_H5,4180,1623,307,11,299,2,307,299,1316,13
RNBC1_QLMSP6_tag05_H6,1981,709,230,7,212,1,230,212,479,8
RNBC1_QLMSP6_tag05_H7,2278,995,172,4,172,2,172,172,823,6
RNBC1_QLMSP7_tag06_A12,131,55,24,2,23,1,24,23,31,3
RNBC1_QLMSP7_tag06_A9,1845,652,215,5,208,2,215,208,437,7
RNBC1_QLMSP7_tag06_H11,180,146,15,10,6,1,15,6,131,11
RNBC1_QLMSP7_tag06_E8,2,1,1,1,1,1,1,1,0,2
RNBC1_QLMSP7_tag06_G10,1,1,0,0,0,0,0,0,1,0
RNBC1_QLMSP7_tag06_H4,61,24,1,1,1,1,1,1,23,2
RNBC1_QLMSP7_tag06_H7,1,1,0,0,0,0,0,0,1,0
